Gene	Essential	Non-essential	Unclear
thrL	FALSE	TRUE	FALSE
thrA	FALSE	TRUE	FALSE
thrB	FALSE	TRUE	FALSE
thrC	FALSE	TRUE	FALSE
yaaX	FALSE	TRUE	FALSE
yaaA	FALSE	TRUE	FALSE
yaaJ	FALSE	TRUE	FALSE
talB	FALSE	TRUE	FALSE
mog	FALSE	TRUE	FALSE
satP	FALSE	TRUE	FALSE
yaaW	FALSE	TRUE	FALSE
yaaI	FALSE	TRUE	FALSE
dnaK	FALSE	FALSE	TRUE
dnaJ	FALSE	TRUE	FALSE
insL1	FALSE	TRUE	FALSE
mokC	FALSE	TRUE	FALSE
hokC	FALSE	TRUE	FALSE
nhaA	FALSE	TRUE	FALSE
nhaR	FALSE	TRUE	FALSE
insB1	FALSE	TRUE	FALSE
insA	FALSE	TRUE	FALSE
rpsT	TRUE	FALSE	FALSE
yaaY	FALSE	TRUE	FALSE
ribF	TRUE	FALSE	FALSE
ileS	TRUE	FALSE	FALSE
lspA	TRUE	FALSE	FALSE
fkpB	FALSE	TRUE	FALSE
ispH	TRUE	FALSE	FALSE
rihC	FALSE	TRUE	FALSE
dapB	TRUE	FALSE	FALSE
carA	FALSE	TRUE	FALSE
carB	FALSE	TRUE	FALSE
caiF	FALSE	TRUE	FALSE
caiE	FALSE	TRUE	FALSE
caiD	FALSE	TRUE	FALSE
caiC	FALSE	TRUE	FALSE
caiB	FALSE	TRUE	FALSE
caiA	FALSE	TRUE	FALSE
caiT	FALSE	TRUE	FALSE
fixA	FALSE	TRUE	FALSE
fixB	FALSE	TRUE	FALSE
fixC	FALSE	TRUE	FALSE
fixX	FALSE	TRUE	FALSE
yaaU	FALSE	TRUE	FALSE
kefF	FALSE	TRUE	FALSE
kefC	FALSE	TRUE	FALSE
folA	TRUE	FALSE	FALSE
apaH	FALSE	TRUE	FALSE
apaG	FALSE	TRUE	FALSE
rsmA	FALSE	TRUE	FALSE
pdxA	FALSE	TRUE	FALSE
surA	FALSE	TRUE	FALSE
lptD	TRUE	FALSE	FALSE
djlA	FALSE	TRUE	FALSE
yabP	FALSE	TRUE	FALSE
rluA	FALSE	TRUE	FALSE
rapA	FALSE	TRUE	FALSE
polB	FALSE	TRUE	FALSE
araD	FALSE	TRUE	FALSE
araC	FALSE	TRUE	FALSE
yabI	FALSE	TRUE	FALSE
thiQ	FALSE	TRUE	FALSE
thiP	FALSE	TRUE	FALSE
thiB	FALSE	TRUE	FALSE
sgrR	FALSE	TRUE	FALSE
sgrT	FALSE	TRUE	FALSE
setA	FALSE	TRUE	FALSE
leuD	FALSE	TRUE	FALSE
leuC	FALSE	TRUE	FALSE
leuB	FALSE	TRUE	FALSE
leuA	FALSE	TRUE	FALSE
leuL	FALSE	TRUE	FALSE
leuO	FALSE	TRUE	FALSE
ilvI	FALSE	TRUE	FALSE
ilvH	FALSE	TRUE	FALSE
cra	FALSE	TRUE	FALSE
mraZ	FALSE	TRUE	FALSE
rsmH	FALSE	TRUE	FALSE
ftsL	FALSE	FALSE	TRUE
ftsI	TRUE	FALSE	FALSE
murE	TRUE	FALSE	FALSE
murF	TRUE	FALSE	FALSE
mraY	TRUE	FALSE	FALSE
murD	TRUE	FALSE	FALSE
ftsW	TRUE	FALSE	FALSE
murG	TRUE	FALSE	FALSE
murC	TRUE	FALSE	FALSE
ddlB	FALSE	TRUE	FALSE
ftsQ	TRUE	FALSE	FALSE
ftsA	TRUE	FALSE	FALSE
ftsZ	TRUE	FALSE	FALSE
lpxC	TRUE	FALSE	FALSE
secM	FALSE	TRUE	FALSE
secA	TRUE	FALSE	FALSE
mutT	FALSE	TRUE	FALSE
yacG	FALSE	TRUE	FALSE
zapD	FALSE	TRUE	FALSE
coaE	TRUE	FALSE	FALSE
guaC	FALSE	TRUE	FALSE
hofC	FALSE	TRUE	FALSE
hofB	FALSE	TRUE	FALSE
ppdD	FALSE	TRUE	FALSE
nadC	FALSE	TRUE	FALSE
ampD	FALSE	TRUE	FALSE
ampE	FALSE	TRUE	FALSE
aroP	FALSE	TRUE	FALSE
pdhR	FALSE	TRUE	FALSE
aceE	TRUE	FALSE	FALSE
aceF	TRUE	FALSE	FALSE
lpd	TRUE	FALSE	FALSE
yacH	FALSE	TRUE	FALSE
acnB	FALSE	FALSE	TRUE
yacL	FALSE	TRUE	FALSE
speD	FALSE	TRUE	FALSE
speE	FALSE	TRUE	FALSE
yacC	FALSE	TRUE	FALSE
cueO	FALSE	TRUE	FALSE
gcd	FALSE	TRUE	FALSE
hpt	FALSE	TRUE	FALSE
can	TRUE	FALSE	FALSE
yadG	FALSE	TRUE	FALSE
yadH	FALSE	TRUE	FALSE
yadI	FALSE	TRUE	FALSE
yadE	FALSE	TRUE	FALSE
panD	FALSE	TRUE	FALSE
yadD	FALSE	TRUE	FALSE
panC	FALSE	TRUE	FALSE
panB	FALSE	TRUE	FALSE
yadC	FALSE	TRUE	FALSE
yadK	FALSE	TRUE	FALSE
yadL	FALSE	TRUE	FALSE
yadM	FALSE	TRUE	FALSE
htrE	FALSE	TRUE	FALSE
yadV	FALSE	TRUE	FALSE
yadN	FALSE	TRUE	FALSE
folK	FALSE	FALSE	TRUE
pcnB	FALSE	TRUE	FALSE
gluQ	FALSE	TRUE	FALSE
dksA	FALSE	TRUE	FALSE
sfsA	FALSE	TRUE	FALSE
ligT	FALSE	TRUE	FALSE
hrpB	FALSE	TRUE	FALSE
mrcB	FALSE	TRUE	FALSE
fhuA	FALSE	TRUE	FALSE
fhuC	FALSE	TRUE	FALSE
fhuD	FALSE	TRUE	FALSE
fhuB	FALSE	TRUE	FALSE
hemL	TRUE	FALSE	FALSE
clcA	FALSE	TRUE	FALSE
erpA	TRUE	FALSE	FALSE
yadS	FALSE	TRUE	FALSE
btuF	FALSE	TRUE	FALSE
mtn	FALSE	FALSE	TRUE
dgt	FALSE	TRUE	FALSE
degP	FALSE	TRUE	FALSE
cdaR	FALSE	TRUE	FALSE
yaeH	FALSE	TRUE	FALSE
yaeI	FALSE	TRUE	FALSE
dapD	TRUE	FALSE	FALSE
glnD	FALSE	TRUE	FALSE
map	TRUE	FALSE	FALSE
rpsB	TRUE	FALSE	FALSE
tsf	TRUE	FALSE	FALSE
pyrH	TRUE	FALSE	FALSE
frr	TRUE	FALSE	FALSE
dxr	TRUE	FALSE	FALSE
ispU	TRUE	FALSE	FALSE
cdsA	TRUE	FALSE	FALSE
rseP	TRUE	FALSE	FALSE
bamA	TRUE	FALSE	FALSE
skp	FALSE	TRUE	FALSE
lpxD	TRUE	FALSE	FALSE
fabZ	TRUE	FALSE	FALSE
lpxA	TRUE	FALSE	FALSE
lpxB	TRUE	FALSE	FALSE
rnhB	FALSE	TRUE	FALSE
dnaE	TRUE	FALSE	FALSE
accA	TRUE	FALSE	FALSE
ldcC	FALSE	TRUE	FALSE
yaeR	FALSE	TRUE	FALSE
tilS	TRUE	FALSE	FALSE
rof	FALSE	TRUE	FALSE
yaeP	FALSE	TRUE	FALSE
yaeQ	FALSE	TRUE	FALSE
arfB	FALSE	TRUE	FALSE
nlpE	FALSE	TRUE	FALSE
yaeF	FALSE	TRUE	FALSE
proS	TRUE	FALSE	FALSE
tsaA	FALSE	TRUE	FALSE
rcsF	FALSE	TRUE	FALSE
metQ	FALSE	TRUE	FALSE
metI	FALSE	TRUE	FALSE
metN	FALSE	TRUE	FALSE
gmhB	FALSE	TRUE	FALSE
dkgB	FALSE	TRUE	FALSE
yafC	FALSE	TRUE	FALSE
yafD	FALSE	TRUE	FALSE
yafE	FALSE	TRUE	FALSE
mltD	FALSE	TRUE	FALSE
gloB	FALSE	TRUE	FALSE
yafS	FALSE	TRUE	FALSE
rnhA	FALSE	FALSE	TRUE
dnaQ	FALSE	FALSE	TRUE
yafT	FALSE	TRUE	FALSE
ykfM	TRUE	FALSE	FALSE
yafU	FALSE	TRUE	FALSE
yafF	FALSE	TRUE	FALSE
yafV	FALSE	TRUE	FALSE
ivy	FALSE	TRUE	FALSE
fadE	FALSE	TRUE	FALSE
gmhA	TRUE	FALSE	FALSE
yafJ	FALSE	TRUE	FALSE
yafK	FALSE	TRUE	FALSE
yafQ	FALSE	TRUE	FALSE
dinJ	FALSE	TRUE	FALSE
yafL	FALSE	TRUE	FALSE
rayT	FALSE	TRUE	FALSE
lfhA	FALSE	TRUE	FALSE
lafU	FALSE	TRUE	FALSE
dinB	FALSE	TRUE	FALSE
yafN	FALSE	TRUE	FALSE
yafO	FALSE	TRUE	FALSE
yafP	FALSE	TRUE	FALSE
ykfJ	FALSE	TRUE	FALSE
prfH	FALSE	TRUE	FALSE
pepD	FALSE	TRUE	FALSE
gpt	FALSE	TRUE	FALSE
frsA	FALSE	TRUE	FALSE
crl	FALSE	TRUE	FALSE
phoE	FALSE	TRUE	FALSE
proB	FALSE	TRUE	FALSE
proA	FALSE	TRUE	FALSE
ykfN	FALSE	TRUE	FALSE
ykfI	FALSE	TRUE	FALSE
yafW	FALSE	TRUE	FALSE
ykfH	FALSE	TRUE	FALSE
ykfG	FALSE	TRUE	FALSE
yafX	FALSE	TRUE	FALSE
ykfF	FALSE	TRUE	FALSE
ykfB	FALSE	TRUE	FALSE
yafY	FALSE	TRUE	FALSE
ykfL	FALSE	TRUE	FALSE
ykfK	FALSE	TRUE	FALSE
yafZ	FALSE	TRUE	FALSE
ykfA	FALSE	TRUE	FALSE
perR	FALSE	TRUE	FALSE
insN	FALSE	TRUE	FALSE
insI1	FALSE	TRUE	FALSE
ykfC	FALSE	TRUE	FALSE
insH1	FALSE	TRUE	FALSE
mmuP	FALSE	TRUE	FALSE
mmuM	FALSE	TRUE	FALSE
afuC	FALSE	TRUE	FALSE
afuB	FALSE	TRUE	FALSE
insB1	FALSE	TRUE	FALSE
insA	FALSE	TRUE	FALSE
insI1	FALSE	TRUE	FALSE
insX	FALSE	TRUE	FALSE
yagB	FALSE	TRUE	FALSE
yagA	FALSE	TRUE	FALSE
yagE	FALSE	TRUE	FALSE
yagF	FALSE	TRUE	FALSE
yagG	FALSE	TRUE	FALSE
yagH	FALSE	TRUE	FALSE
yagI	FALSE	TRUE	FALSE
argF	FALSE	TRUE	FALSE
ykgS	FALSE	TRUE	FALSE
insB1	FALSE	TRUE	FALSE
insA	FALSE	TRUE	FALSE
yagJ	FALSE	TRUE	FALSE
yagK	FALSE	TRUE	FALSE
yagL	FALSE	TRUE	FALSE
yagM	FALSE	TRUE	FALSE
yagN	FALSE	TRUE	FALSE
intF	FALSE	TRUE	FALSE
yagP	FALSE	TRUE	FALSE
ykgT	FALSE	TRUE	FALSE
paoD	FALSE	TRUE	FALSE
paoC	FALSE	TRUE	FALSE
paoB	FALSE	TRUE	FALSE
paoA	FALSE	TRUE	FALSE
yagU	FALSE	TRUE	FALSE
ykgJ	FALSE	TRUE	FALSE
ecpE	FALSE	TRUE	FALSE
ecpD	FALSE	TRUE	FALSE
ecpC	FALSE	TRUE	FALSE
ecpB	FALSE	TRUE	FALSE
ecpA	FALSE	TRUE	FALSE
ecpR	FALSE	TRUE	FALSE
ykgL	FALSE	TRUE	FALSE
ykgO	FALSE	TRUE	FALSE
ykgM	FALSE	TRUE	FALSE
ykgR	FALSE	TRUE	FALSE
ykgP	FALSE	TRUE	FALSE
eaeH	FALSE	TRUE	FALSE
insE1	FALSE	TRUE	FALSE
insF1	FALSE	TRUE	FALSE
ykgA	FALSE	TRUE	FALSE
ykgQ	FALSE	TRUE	FALSE
rclC	FALSE	TRUE	FALSE
rclB	FALSE	TRUE	FALSE
rclA	FALSE	TRUE	FALSE
rclR	FALSE	TRUE	FALSE
ykgE	FALSE	TRUE	FALSE
ykgF	FALSE	TRUE	FALSE
ykgG	FALSE	TRUE	FALSE
ykgH	FALSE	TRUE	FALSE
betA	FALSE	TRUE	FALSE
betB	FALSE	TRUE	FALSE
betI	FALSE	TRUE	FALSE
betT	FALSE	TRUE	FALSE
yahA	FALSE	TRUE	FALSE
yahB	FALSE	TRUE	FALSE
yahC	FALSE	TRUE	FALSE
yahD	FALSE	TRUE	FALSE
yahE	FALSE	TRUE	FALSE
yahF	FALSE	TRUE	FALSE
yahG	FALSE	TRUE	FALSE
yahI	FALSE	TRUE	FALSE
yahJ	FALSE	TRUE	FALSE
yahK	FALSE	TRUE	FALSE
yahL	FALSE	TRUE	FALSE
yahM	FALSE	TRUE	FALSE
yahN	FALSE	TRUE	FALSE
yahO	FALSE	TRUE	FALSE
prpR	FALSE	TRUE	FALSE
prpB	FALSE	TRUE	FALSE
prpC	FALSE	TRUE	FALSE
prpD	FALSE	TRUE	FALSE
prpE	FALSE	TRUE	FALSE
codB	FALSE	TRUE	FALSE
codA	FALSE	TRUE	FALSE
cynR	FALSE	TRUE	FALSE
cynT	FALSE	TRUE	FALSE
cynS	FALSE	TRUE	FALSE
cynX	FALSE	TRUE	FALSE
lacA	FALSE	TRUE	FALSE
lacY	FALSE	TRUE	FALSE
lacZ	FALSE	TRUE	FALSE
lacI	FALSE	TRUE	FALSE
mhpR	FALSE	TRUE	FALSE
mhpA	FALSE	TRUE	FALSE
mhpB	FALSE	TRUE	FALSE
mhpC	FALSE	TRUE	FALSE
mhpD	FALSE	TRUE	FALSE
mhpF	FALSE	TRUE	FALSE
mhpE	FALSE	TRUE	FALSE
mhpT	FALSE	TRUE	FALSE
yaiL	FALSE	TRUE	FALSE
frmB	FALSE	TRUE	FALSE
frmA	FALSE	TRUE	FALSE
frmR	FALSE	TRUE	FALSE
yaiO	FALSE	TRUE	FALSE
yaiX	FALSE	TRUE	FALSE
insC1	FALSE	TRUE	FALSE
insD1	FALSE	TRUE	FALSE
yaiP	FALSE	TRUE	FALSE
yaiS	FALSE	TRUE	FALSE
tauA	FALSE	TRUE	FALSE
tauB	FALSE	TRUE	FALSE
tauC	FALSE	TRUE	FALSE
tauD	FALSE	TRUE	FALSE
hemB	TRUE	FALSE	FALSE
yaiT	FALSE	TRUE	FALSE
insF1	FALSE	TRUE	FALSE
insE1	FALSE	TRUE	FALSE
yaiV	FALSE	TRUE	FALSE
ampH	FALSE	TRUE	FALSE
sbmA	FALSE	TRUE	FALSE
yaiW	FALSE	TRUE	FALSE
yaiY	FALSE	TRUE	FALSE
yaiZ	FALSE	TRUE	FALSE
ddlA	FALSE	TRUE	FALSE
iraP	FALSE	TRUE	FALSE
phoA	FALSE	TRUE	FALSE
psiF	FALSE	TRUE	FALSE
yaiC	FALSE	TRUE	FALSE
proC	FALSE	TRUE	FALSE
yaiI	FALSE	TRUE	FALSE
aroL	FALSE	TRUE	FALSE
yaiA	FALSE	TRUE	FALSE
aroM	FALSE	TRUE	FALSE
yaiE	FALSE	TRUE	FALSE
ykiA	FALSE	TRUE	FALSE
rdgC	FALSE	TRUE	FALSE
mak	FALSE	TRUE	FALSE
araJ	FALSE	TRUE	FALSE
sbcC	FALSE	TRUE	FALSE
sbcD	FALSE	TRUE	FALSE
phoB	FALSE	TRUE	FALSE
phoR	FALSE	TRUE	FALSE
brnQ	FALSE	TRUE	FALSE
proY	FALSE	TRUE	FALSE
malZ	FALSE	TRUE	FALSE
acpH	FALSE	TRUE	FALSE
queA	FALSE	TRUE	FALSE
tgt	FALSE	TRUE	FALSE
yajC	FALSE	TRUE	FALSE
secD	TRUE	FALSE	FALSE
secF	FALSE	FALSE	TRUE
yajD	FALSE	TRUE	FALSE
tsx	FALSE	TRUE	FALSE
yajI	FALSE	TRUE	FALSE
nrdR	FALSE	FALSE	TRUE
ribD	TRUE	FALSE	FALSE
ribE	TRUE	FALSE	FALSE
nusB	TRUE	FALSE	FALSE
thiL	TRUE	FALSE	FALSE
pgpA	FALSE	TRUE	FALSE
yajO	FALSE	TRUE	FALSE
dxs	TRUE	FALSE	FALSE
ispA	TRUE	FALSE	FALSE
xseB	FALSE	TRUE	FALSE
thiI	FALSE	TRUE	FALSE
yajL	FALSE	TRUE	FALSE
panE	FALSE	TRUE	FALSE
yajQ	FALSE	TRUE	FALSE
yajR	FALSE	TRUE	FALSE
cyoE	FALSE	TRUE	FALSE
cyoD	FALSE	TRUE	FALSE
cyoC	FALSE	TRUE	FALSE
cyoB	FALSE	TRUE	FALSE
cyoA	FALSE	TRUE	FALSE
ampG	FALSE	TRUE	FALSE
yajG	FALSE	TRUE	FALSE
bolA	FALSE	TRUE	FALSE
tig	FALSE	TRUE	FALSE
clpP	FALSE	TRUE	FALSE
clpX	FALSE	TRUE	FALSE
lon	FALSE	TRUE	FALSE
hupB	FALSE	TRUE	FALSE
ppiD	FALSE	TRUE	FALSE
ybaV	FALSE	TRUE	FALSE
fadM	FALSE	TRUE	FALSE
queC	FALSE	TRUE	FALSE
ybaE	FALSE	TRUE	FALSE
cof	FALSE	TRUE	FALSE
ybaO	FALSE	TRUE	FALSE
mdlA	FALSE	TRUE	FALSE
mdlB	FALSE	TRUE	FALSE
glnK	FALSE	TRUE	FALSE
amtB	FALSE	TRUE	FALSE
tesB	FALSE	TRUE	FALSE
ybaY	FALSE	TRUE	FALSE
ybaZ	FALSE	TRUE	FALSE
ybaA	FALSE	TRUE	FALSE
ylaB	FALSE	TRUE	FALSE
ylaC	FALSE	TRUE	FALSE
maa	FALSE	TRUE	FALSE
hha	FALSE	TRUE	FALSE
tomB	FALSE	TRUE	FALSE
acrB	FALSE	TRUE	FALSE
acrA	FALSE	TRUE	FALSE
acrR	FALSE	TRUE	FALSE
mscK	FALSE	TRUE	FALSE
ybaM	FALSE	TRUE	FALSE
priC	FALSE	TRUE	FALSE
ybaN	FALSE	TRUE	FALSE
apt	FALSE	TRUE	FALSE
dnaX	TRUE	FALSE	FALSE
ybaB	FALSE	TRUE	FALSE
recR	FALSE	TRUE	FALSE
htpG	FALSE	TRUE	FALSE
adk	TRUE	FALSE	FALSE
hemH	TRUE	FALSE	FALSE
aes	FALSE	TRUE	FALSE
gsk	FALSE	TRUE	FALSE
ybaL	FALSE	TRUE	FALSE
fsr	FALSE	TRUE	FALSE
ushA	FALSE	TRUE	FALSE
ybaK	FALSE	TRUE	FALSE
ybaP	FALSE	TRUE	FALSE
ybaQ	FALSE	TRUE	FALSE
copA	FALSE	TRUE	FALSE
glsA	FALSE	TRUE	FALSE
ybaT	FALSE	TRUE	FALSE
cueR	FALSE	TRUE	FALSE
ybbJ	FALSE	TRUE	FALSE
qmcA	FALSE	TRUE	FALSE
fetA	FALSE	TRUE	FALSE
fetB	FALSE	TRUE	FALSE
ybbN	FALSE	TRUE	FALSE
ybbO	FALSE	TRUE	FALSE
tesA	FALSE	TRUE	FALSE
ybbA	FALSE	TRUE	FALSE
ybbP	FALSE	TRUE	FALSE
rhsD	FALSE	TRUE	FALSE
ybbC	FALSE	TRUE	FALSE
rhsH	FALSE	TRUE	FALSE
ybbD	FALSE	TRUE	FALSE
ylbI	FALSE	TRUE	FALSE
ylbG	FALSE	TRUE	FALSE
mnmH	FALSE	TRUE	FALSE
allS	FALSE	TRUE	FALSE
allA	FALSE	TRUE	FALSE
allR	FALSE	TRUE	FALSE
gcl	FALSE	TRUE	FALSE
hyi	FALSE	TRUE	FALSE
glxR	FALSE	TRUE	FALSE
ybbW	FALSE	TRUE	FALSE
allB	FALSE	TRUE	FALSE
ybbY	FALSE	TRUE	FALSE
glxK	FALSE	TRUE	FALSE
allE	FALSE	TRUE	FALSE
allC	FALSE	TRUE	FALSE
allD	FALSE	TRUE	FALSE
fdrA	FALSE	TRUE	FALSE
ylbE	FALSE	TRUE	FALSE
ylbF	FALSE	TRUE	FALSE
ybcF	FALSE	TRUE	FALSE
purK	FALSE	TRUE	FALSE
purE	FALSE	TRUE	FALSE
lpxH	TRUE	FALSE	FALSE
ppiB	FALSE	FALSE	TRUE
cysS	TRUE	FALSE	FALSE
ybcI	FALSE	TRUE	FALSE
ybcJ	FALSE	TRUE	FALSE
folD	TRUE	FALSE	FALSE
sfmA	FALSE	TRUE	FALSE
sfmC	FALSE	TRUE	FALSE
sfmD	FALSE	TRUE	FALSE
sfmH	FALSE	TRUE	FALSE
sfmF	FALSE	TRUE	FALSE
sfmZ	FALSE	TRUE	FALSE
intD	FALSE	TRUE	FALSE
xisD	FALSE	TRUE	FALSE
exoD	FALSE	TRUE	FALSE
peaD	FALSE	TRUE	FALSE
renD	FALSE	TRUE	FALSE
insE1	FALSE	TRUE	FALSE
insF1	FALSE	TRUE	FALSE
emrE	FALSE	TRUE	FALSE
ybcK	FALSE	TRUE	FALSE
ybcL	FALSE	TRUE	FALSE
ybcM	FALSE	TRUE	FALSE
ylcH	FALSE	TRUE	FALSE
ybcN	FALSE	TRUE	FALSE
ninE	FALSE	TRUE	FALSE
ybcO	FALSE	TRUE	FALSE
rusA	FALSE	TRUE	FALSE
ylcG	FALSE	TRUE	FALSE
quuD	FALSE	TRUE	FALSE
nmpC	FALSE	TRUE	FALSE
insH1	FALSE	TRUE	FALSE
essD	FALSE	TRUE	FALSE
rrrD	FALSE	TRUE	FALSE
rzpD	FALSE	TRUE	FALSE
rzoD	FALSE	TRUE	FALSE
borD	FALSE	TRUE	FALSE
ybcV	FALSE	TRUE	FALSE
ybcW	FALSE	TRUE	FALSE
ylcI	FALSE	TRUE	FALSE
nohD	FALSE	TRUE	FALSE
aaaD	FALSE	TRUE	FALSE
tfaD	FALSE	TRUE	FALSE
ybcY	FALSE	TRUE	FALSE
tfaX	FALSE	TRUE	FALSE
appY	FALSE	FALSE	TRUE
ompT	FALSE	TRUE	FALSE
envY	FALSE	TRUE	FALSE
ybcH	FALSE	TRUE	FALSE
nfrA	FALSE	TRUE	FALSE
nfrB	FALSE	TRUE	FALSE
cusS	FALSE	TRUE	FALSE
cusR	FALSE	TRUE	FALSE
cusC	FALSE	TRUE	FALSE
cusF	FALSE	TRUE	FALSE
cusB	FALSE	TRUE	FALSE
cusA	FALSE	TRUE	FALSE
pheP	FALSE	TRUE	FALSE
ybdG	FALSE	TRUE	FALSE
nfsB	FALSE	TRUE	FALSE
ybdF	FALSE	TRUE	FALSE
ybdJ	FALSE	TRUE	FALSE
ybdK	FALSE	TRUE	FALSE
hokE	FALSE	TRUE	FALSE
insL1	FALSE	TRUE	FALSE
entD	FALSE	TRUE	FALSE
fepA	FALSE	TRUE	FALSE
fes	FALSE	TRUE	FALSE
ybdZ	FALSE	TRUE	FALSE
entF	FALSE	TRUE	FALSE
fepE	FALSE	TRUE	FALSE
fepC	FALSE	TRUE	FALSE
fepG	FALSE	TRUE	FALSE
fepD	FALSE	TRUE	FALSE
entS	FALSE	TRUE	FALSE
fepB	FALSE	TRUE	FALSE
entC	FALSE	TRUE	FALSE
entE	FALSE	TRUE	FALSE
entB	FALSE	TRUE	FALSE
entA	FALSE	TRUE	FALSE
entH	FALSE	TRUE	FALSE
cstA	FALSE	TRUE	FALSE
ybdD	FALSE	TRUE	FALSE
ybdH	FALSE	TRUE	FALSE
ybdL	FALSE	TRUE	FALSE
ybdM	FALSE	TRUE	FALSE
ybdN	FALSE	TRUE	FALSE
ybdO	FALSE	TRUE	FALSE
dsbG	FALSE	TRUE	FALSE
ahpC	FALSE	TRUE	FALSE
ahpF	FALSE	TRUE	FALSE
uspG	FALSE	TRUE	FALSE
ybdR	FALSE	TRUE	FALSE
rnk	FALSE	TRUE	FALSE
rna	FALSE	TRUE	FALSE
citT	FALSE	TRUE	FALSE
citG	FALSE	TRUE	FALSE
citX	FALSE	TRUE	FALSE
citF	FALSE	TRUE	FALSE
citE	FALSE	TRUE	FALSE
citD	FALSE	TRUE	FALSE
citC	FALSE	TRUE	FALSE
citA	FALSE	TRUE	FALSE
citB	FALSE	TRUE	FALSE
dcuC	FALSE	TRUE	FALSE
pagP	FALSE	TRUE	FALSE
cspE	FALSE	TRUE	FALSE
flc	FALSE	TRUE	FALSE
ybeM	FALSE	TRUE	FALSE
tatE	FALSE	TRUE	FALSE
lipA	TRUE	FALSE	FALSE
ybeF	FALSE	TRUE	FALSE
lipB	FALSE	TRUE	FALSE
ybeD	TRUE	FALSE	FALSE
dacA	FALSE	TRUE	FALSE
rlpA	FALSE	TRUE	FALSE
mrdB	TRUE	FALSE	FALSE
mrdA	TRUE	FALSE	FALSE
rlmH	FALSE	TRUE	FALSE
rsfS	FALSE	TRUE	FALSE
cobC	FALSE	TRUE	FALSE
nadD	TRUE	FALSE	FALSE
holA	TRUE	FALSE	FALSE
lptE	TRUE	FALSE	FALSE
leuS	TRUE	FALSE	FALSE
ybeL	FALSE	TRUE	FALSE
ybeQ	FALSE	TRUE	FALSE
ybeR	FALSE	TRUE	FALSE
djlB	FALSE	TRUE	FALSE
ybeT	FALSE	TRUE	FALSE
ybeU	FALSE	TRUE	FALSE
djlC	FALSE	TRUE	FALSE
hscC	FALSE	TRUE	FALSE
rihA	FALSE	TRUE	FALSE
gltL	FALSE	TRUE	FALSE
gltK	FALSE	TRUE	FALSE
gltJ	FALSE	TRUE	FALSE
gltI	FALSE	TRUE	FALSE
insH1	FALSE	TRUE	FALSE
lnt	TRUE	FALSE	FALSE
ybeX	FALSE	TRUE	FALSE
ybeY	TRUE	FALSE	FALSE
ybeZ	FALSE	TRUE	FALSE
miaB	FALSE	TRUE	FALSE
ubiF	TRUE	FALSE	FALSE
asnB	FALSE	TRUE	FALSE
umpH	FALSE	TRUE	FALSE
nagC	FALSE	TRUE	FALSE
nagA	FALSE	TRUE	FALSE
nagB	FALSE	TRUE	FALSE
nagE	FALSE	TRUE	FALSE
glnS	TRUE	FALSE	FALSE
chiP	FALSE	TRUE	FALSE
chiQ	FALSE	TRUE	FALSE
fur	FALSE	TRUE	FALSE
uof	FALSE	TRUE	FALSE
fldA	TRUE	FALSE	FALSE
ybfE	FALSE	TRUE	FALSE
ybfF	FALSE	TRUE	FALSE
seqA	TRUE	FALSE	FALSE
pgm	FALSE	FALSE	TRUE
ybfP	FALSE	TRUE	FALSE
ybfG	FALSE	TRUE	FALSE
ybfI	FALSE	TRUE	FALSE
potE	FALSE	TRUE	FALSE
speF	FALSE	TRUE	FALSE
ybfK	FALSE	TRUE	FALSE
kdpE	FALSE	TRUE	FALSE
kdpD	FALSE	TRUE	FALSE
kdpC	FALSE	TRUE	FALSE
kdpB	FALSE	TRUE	FALSE
kdpA	FALSE	TRUE	FALSE
kdpF	FALSE	TRUE	FALSE
ybfA	FALSE	TRUE	FALSE
rhsC	FALSE	TRUE	FALSE
ybfB	FALSE	FALSE	TRUE
rhsO	FALSE	TRUE	FALSE
ybfC	FALSE	TRUE	FALSE
ybfQ	FALSE	FALSE	TRUE
ybfL	FALSE	TRUE	FALSE
ybfD	FALSE	TRUE	FALSE
ybgA	FALSE	TRUE	FALSE
phr	FALSE	TRUE	FALSE
dtpD	FALSE	TRUE	FALSE
ybgI	FALSE	TRUE	FALSE
ybgJ	FALSE	TRUE	FALSE
ybgK	FALSE	TRUE	FALSE
ybgL	FALSE	TRUE	FALSE
nei	FALSE	TRUE	FALSE
abrB	FALSE	TRUE	FALSE
ybgO	FALSE	TRUE	FALSE
ybgP	FALSE	TRUE	FALSE
ybgQ	FALSE	TRUE	FALSE
ybgD	FALSE	TRUE	FALSE
gltA	FALSE	TRUE	FALSE
sdhC	FALSE	TRUE	FALSE
sdhD	FALSE	TRUE	FALSE
sdhA	FALSE	TRUE	FALSE
sdhB	FALSE	TRUE	FALSE
sucA	TRUE	FALSE	FALSE
sucB	TRUE	FALSE	FALSE
sucC	FALSE	TRUE	FALSE
sucD	FALSE	TRUE	FALSE
mngR	FALSE	TRUE	FALSE
mngA	FALSE	TRUE	FALSE
mngB	FALSE	TRUE	FALSE
cydA	TRUE	FALSE	FALSE
cydB	TRUE	FALSE	FALSE
cydX	FALSE	FALSE	TRUE
ybgE	FALSE	TRUE	FALSE
ybgC	FALSE	TRUE	FALSE
tolQ	FALSE	TRUE	FALSE
tolR	FALSE	TRUE	FALSE
tolA	FALSE	FALSE	TRUE
tolB	FALSE	TRUE	FALSE
pal	FALSE	TRUE	FALSE
ybgF	FALSE	TRUE	FALSE
nadA	FALSE	TRUE	FALSE
pnuC	FALSE	TRUE	FALSE
zitB	FALSE	TRUE	FALSE
ybgS	FALSE	TRUE	FALSE
aroG	FALSE	TRUE	FALSE
gpmA	FALSE	TRUE	FALSE
galM	FALSE	TRUE	FALSE
galK	FALSE	TRUE	FALSE
galT	FALSE	TRUE	FALSE
galE	FALSE	TRUE	FALSE
modF	FALSE	TRUE	FALSE
modE	FALSE	TRUE	FALSE
acrZ	FALSE	TRUE	FALSE
modA	FALSE	TRUE	FALSE
modB	FALSE	TRUE	FALSE
modC	FALSE	TRUE	FALSE
ybhA	FALSE	TRUE	FALSE
pgl	FALSE	TRUE	FALSE
ybhD	FALSE	TRUE	FALSE
ybhH	FALSE	TRUE	FALSE
ybhI	FALSE	TRUE	FALSE
ybhJ	FALSE	TRUE	FALSE
ybhC	FALSE	TRUE	FALSE
ybhB	FALSE	TRUE	FALSE
bioA	FALSE	TRUE	FALSE
bioB	FALSE	TRUE	FALSE
bioF	FALSE	TRUE	FALSE
bioC	FALSE	TRUE	FALSE
bioD	FALSE	TRUE	FALSE
uvrB	FALSE	TRUE	FALSE
ybhK	FALSE	TRUE	FALSE
moaA	FALSE	TRUE	FALSE
moaB	FALSE	TRUE	FALSE
moaC	FALSE	TRUE	FALSE
moaD	FALSE	TRUE	FALSE
moaE	FALSE	TRUE	FALSE
ybhL	FALSE	TRUE	FALSE
ybhM	FALSE	TRUE	FALSE
ybhN	FALSE	TRUE	FALSE
clsB	FALSE	TRUE	FALSE
ybhP	FALSE	TRUE	FALSE
ybhQ	FALSE	TRUE	FALSE
ybhR	FALSE	TRUE	FALSE
ybhS	FALSE	TRUE	FALSE
ybhF	FALSE	TRUE	FALSE
ybhG	FALSE	TRUE	FALSE
ybiH	FALSE	TRUE	FALSE
rhlE	FALSE	TRUE	FALSE
ybiA	FALSE	TRUE	FALSE
dinG	FALSE	TRUE	FALSE
ybiB	FALSE	TRUE	FALSE
ybiC	FALSE	TRUE	FALSE
ybiJ	FALSE	TRUE	FALSE
ybiI	FALSE	TRUE	FALSE
ybiX	FALSE	TRUE	FALSE
fiu	FALSE	TRUE	FALSE
mcbA	FALSE	TRUE	FALSE
rlmF	FALSE	TRUE	FALSE
ybiO	FALSE	TRUE	FALSE
glnQ	FALSE	TRUE	FALSE
glnP	FALSE	TRUE	FALSE
glnH	FALSE	TRUE	FALSE
dps	FALSE	TRUE	FALSE
rhtA	FALSE	TRUE	FALSE
ompX	FALSE	TRUE	FALSE
ybiP	FALSE	TRUE	FALSE
mntS	FALSE	TRUE	FALSE
mntR	FALSE	TRUE	FALSE
ybiR	FALSE	TRUE	FALSE
ldtB	FALSE	TRUE	FALSE
ybiT	FALSE	TRUE	FALSE
ybiU	FALSE	TRUE	FALSE
ybiV	FALSE	TRUE	FALSE
ybiW	FALSE	TRUE	FALSE
ybiY	FALSE	TRUE	FALSE
fsaA	FALSE	TRUE	FALSE
moeB	FALSE	TRUE	FALSE
moeA	FALSE	TRUE	FALSE
iaaA	FALSE	TRUE	FALSE
gsiA	FALSE	TRUE	FALSE
gsiB	FALSE	TRUE	FALSE
gsiC	FALSE	TRUE	FALSE
gsiD	FALSE	TRUE	FALSE
yliE	FALSE	TRUE	FALSE
yliF	FALSE	TRUE	FALSE
rimO	FALSE	TRUE	FALSE
bssR	FALSE	TRUE	FALSE
yliI	FALSE	TRUE	FALSE
gstB	FALSE	TRUE	FALSE
dacC	FALSE	TRUE	FALSE
deoR	FALSE	TRUE	FALSE
ybjG	FALSE	TRUE	FALSE
mdfA	FALSE	TRUE	FALSE
ybjH	FALSE	TRUE	FALSE
ybjI	FALSE	TRUE	FALSE
ybjJ	FALSE	TRUE	FALSE
rcdA	FALSE	TRUE	FALSE
ybjL	FALSE	TRUE	FALSE
ybjM	FALSE	TRUE	FALSE
grxA	FALSE	TRUE	FALSE
ybjC	FALSE	TRUE	FALSE
nfsA	FALSE	TRUE	FALSE
rimK	FALSE	TRUE	FALSE
ybjN	FALSE	TRUE	FALSE
potF	FALSE	TRUE	FALSE
potG	FALSE	TRUE	FALSE
potH	FALSE	TRUE	FALSE
potI	FALSE	TRUE	FALSE
ybjO	FALSE	TRUE	FALSE
rlmC	FALSE	TRUE	FALSE
artJ	FALSE	TRUE	FALSE
artM	FALSE	TRUE	FALSE
artQ	FALSE	TRUE	FALSE
artI	FALSE	TRUE	FALSE
artP	FALSE	TRUE	FALSE
ybjP	FALSE	TRUE	FALSE
ybjQ	FALSE	TRUE	FALSE
amiD	FALSE	TRUE	FALSE
ybjS	FALSE	TRUE	FALSE
ybjT	FALSE	TRUE	FALSE
ltaE	FALSE	TRUE	FALSE
poxB	FALSE	TRUE	FALSE
hcr	FALSE	TRUE	FALSE
hcp	FALSE	TRUE	FALSE
ybjE	FALSE	TRUE	FALSE
aqpZ	FALSE	TRUE	FALSE
ybjD	FALSE	TRUE	FALSE
ybjX	FALSE	TRUE	FALSE
macA	FALSE	TRUE	FALSE
macB	FALSE	TRUE	FALSE
cspD	FALSE	TRUE	FALSE
clpS	FALSE	TRUE	FALSE
clpA	FALSE	TRUE	FALSE
infA	TRUE	FALSE	FALSE
aat	FALSE	TRUE	FALSE
cydC	FALSE	FALSE	TRUE
cydD	TRUE	FALSE	FALSE
trxB	FALSE	TRUE	FALSE
lrp	FALSE	TRUE	FALSE
ftsK	FALSE	FALSE	TRUE
lolA	TRUE	FALSE	FALSE
rarA	FALSE	TRUE	FALSE
serS	TRUE	FALSE	FALSE
dmsA	FALSE	TRUE	FALSE
dmsB	FALSE	TRUE	FALSE
dmsC	FALSE	TRUE	FALSE
ycaC	FALSE	TRUE	FALSE
ycaD	FALSE	TRUE	FALSE
ycaM	FALSE	TRUE	FALSE
ycaN	FALSE	TRUE	FALSE
ycaK	FALSE	TRUE	FALSE
pflA	FALSE	TRUE	FALSE
pflB	FALSE	TRUE	FALSE
focA	FALSE	TRUE	FALSE
ycaO	FALSE	TRUE	FALSE
ycaP	FALSE	TRUE	FALSE
serC	FALSE	TRUE	FALSE
aroA	FALSE	TRUE	FALSE
ycaL	FALSE	TRUE	FALSE
cmk	TRUE	FALSE	FALSE
rpsA	TRUE	FALSE	FALSE
ihfB	FALSE	TRUE	FALSE
ycaI	FALSE	TRUE	FALSE
msbA	TRUE	FALSE	FALSE
lpxK	TRUE	FALSE	FALSE
ycaQ	FALSE	TRUE	FALSE
ycaR	FALSE	TRUE	FALSE
kdsB	TRUE	FALSE	FALSE
ycbJ	FALSE	TRUE	FALSE
ycbC	FALSE	TRUE	FALSE
smtA	FALSE	TRUE	FALSE
mukF	TRUE	FALSE	FALSE
mukE	TRUE	FALSE	FALSE
mukB	TRUE	FALSE	FALSE
ldtD	FALSE	TRUE	FALSE
ycbK	FALSE	TRUE	FALSE
ycbL	FALSE	TRUE	FALSE
aspC	FALSE	TRUE	FALSE
ompF	FALSE	TRUE	FALSE
asnS	TRUE	FALSE	FALSE
pncB	FALSE	TRUE	FALSE
pepN	FALSE	TRUE	FALSE
ssuB	FALSE	TRUE	FALSE
ssuC	FALSE	TRUE	FALSE
ssuD	FALSE	TRUE	FALSE
ssuA	FALSE	TRUE	FALSE
ssuE	FALSE	TRUE	FALSE
elfA	FALSE	TRUE	FALSE
elfD	FALSE	TRUE	FALSE
elfC	FALSE	TRUE	FALSE
elfG	FALSE	TRUE	FALSE
ycbU	FALSE	TRUE	FALSE
ycbV	FALSE	TRUE	FALSE
ycbF	FALSE	TRUE	FALSE
pyrD	FALSE	TRUE	FALSE
zapC	FALSE	TRUE	FALSE
ycbX	FALSE	TRUE	FALSE
rlmL	FALSE	TRUE	FALSE
uup	FALSE	TRUE	FALSE
pqiA	FALSE	TRUE	FALSE
pqiB	FALSE	TRUE	FALSE
pqiC	FALSE	TRUE	FALSE
rmf	FALSE	TRUE	FALSE
fabA	TRUE	FALSE	FALSE
ycbZ	FALSE	TRUE	FALSE
matP	FALSE	FALSE	TRUE
ompA	FALSE	TRUE	FALSE
sulA	FALSE	TRUE	FALSE
sxy	FALSE	TRUE	FALSE
yccS	FALSE	TRUE	FALSE
yccF	FALSE	TRUE	FALSE
helD	FALSE	TRUE	FALSE
mgsA	FALSE	TRUE	FALSE
yccT	FALSE	TRUE	FALSE
yccU	FALSE	TRUE	FALSE
hspQ	FALSE	TRUE	FALSE
rlmI	FALSE	TRUE	FALSE
yccX	FALSE	TRUE	FALSE
tusE	TRUE	FALSE	FALSE
yccA	FALSE	TRUE	FALSE
hyaA	FALSE	TRUE	FALSE
hyaB	FALSE	TRUE	FALSE
hyaC	FALSE	TRUE	FALSE
hyaD	FALSE	TRUE	FALSE
hyaE	FALSE	TRUE	FALSE
hyaF	FALSE	TRUE	FALSE
cbdA	FALSE	TRUE	FALSE
cbdB	FALSE	TRUE	FALSE
cbdX	FALSE	TRUE	FALSE
appA	FALSE	TRUE	FALSE
etk	FALSE	TRUE	FALSE
etp	FALSE	TRUE	FALSE
gfcE	FALSE	TRUE	FALSE
gfcD	FALSE	TRUE	FALSE
gfcC	FALSE	TRUE	FALSE
gfcB	FALSE	TRUE	FALSE
gfcA	FALSE	TRUE	FALSE
insA	FALSE	TRUE	FALSE
insB1	FALSE	TRUE	FALSE
cspH	FALSE	TRUE	FALSE
cspG	FALSE	TRUE	FALSE
ymcE	FALSE	TRUE	FALSE
gnsA	FALSE	FALSE	TRUE
yccM	FALSE	TRUE	FALSE
torS	FALSE	TRUE	FALSE
torT	FALSE	TRUE	FALSE
torR	FALSE	TRUE	FALSE
torC	FALSE	TRUE	FALSE
torA	FALSE	TRUE	FALSE
torD	FALSE	TRUE	FALSE
cbpM	FALSE	TRUE	FALSE
cbpA	FALSE	TRUE	FALSE
yccE	FALSE	FALSE	TRUE
agp	FALSE	TRUE	FALSE
yccJ	FALSE	TRUE	FALSE
wrbA	FALSE	TRUE	FALSE
ymdF	FALSE	TRUE	FALSE
rutG	FALSE	TRUE	FALSE
rutF	FALSE	TRUE	FALSE
rutE	FALSE	TRUE	FALSE
rutD	FALSE	TRUE	FALSE
rutC	FALSE	TRUE	FALSE
rutB	FALSE	TRUE	FALSE
rutA	FALSE	TRUE	FALSE
rutR	FALSE	TRUE	FALSE
putA	FALSE	TRUE	FALSE
putP	FALSE	TRUE	FALSE
efeU	FALSE	TRUE	FALSE
efeO	FALSE	TRUE	FALSE
efeB	FALSE	TRUE	FALSE
phoH	FALSE	TRUE	FALSE
pgaD	FALSE	TRUE	FALSE
pgaC	FALSE	TRUE	FALSE
pgaB	FALSE	TRUE	FALSE
pgaA	FALSE	TRUE	FALSE
ycdT	FALSE	TRUE	FALSE
insF1	FALSE	TRUE	FALSE
insE1	FALSE	TRUE	FALSE
ymdE	FALSE	TRUE	FALSE
ycdU	FALSE	TRUE	FALSE
ghrA	FALSE	TRUE	FALSE
ycdX	FALSE	TRUE	FALSE
ycdY	FALSE	TRUE	FALSE
ycdZ	FALSE	TRUE	FALSE
csgG	FALSE	TRUE	FALSE
csgF	FALSE	TRUE	FALSE
csgE	FALSE	TRUE	FALSE
csgD	FALSE	TRUE	FALSE
csgB	FALSE	TRUE	FALSE
csgA	FALSE	TRUE	FALSE
csgC	FALSE	TRUE	FALSE
ymdA	FALSE	TRUE	FALSE
ymdB	FALSE	TRUE	FALSE
clsC	FALSE	TRUE	FALSE
opgC	FALSE	TRUE	FALSE
opgG	FALSE	TRUE	FALSE
opgH	FALSE	TRUE	FALSE
yceK	FALSE	TRUE	FALSE
msyB	FALSE	TRUE	FALSE
mdtG	FALSE	TRUE	FALSE
lpxL	TRUE	FALSE	FALSE
yceA	FALSE	TRUE	FALSE
yceI	FALSE	TRUE	FALSE
yceJ	FALSE	TRUE	FALSE
yceO	FALSE	TRUE	FALSE
solA	FALSE	TRUE	FALSE
bssS	FALSE	TRUE	FALSE
dinI	FALSE	TRUE	FALSE
pyrC	FALSE	TRUE	FALSE
yceB	FALSE	TRUE	FALSE
grxB	FALSE	TRUE	FALSE
mdtH	FALSE	TRUE	FALSE
rimJ	FALSE	TRUE	FALSE
yceH	FALSE	TRUE	FALSE
yceM	FALSE	TRUE	FALSE
murJ	TRUE	FALSE	FALSE
flgN	FALSE	TRUE	FALSE
flgM	FALSE	TRUE	FALSE
flgA	FALSE	TRUE	FALSE
flgB	FALSE	TRUE	FALSE
flgC	FALSE	TRUE	FALSE
flgD	FALSE	TRUE	FALSE
flgE	FALSE	TRUE	FALSE
flgF	FALSE	TRUE	FALSE
flgG	FALSE	TRUE	FALSE
flgH	FALSE	TRUE	FALSE
flgI	FALSE	TRUE	FALSE
flgJ	FALSE	TRUE	FALSE
flgK	FALSE	TRUE	FALSE
flgL	FALSE	TRUE	FALSE
rne	FALSE	FALSE	TRUE
yceQ	FALSE	TRUE	FALSE
rluC	FALSE	TRUE	FALSE
yceF	FALSE	TRUE	FALSE
yceD	FALSE	TRUE	FALSE
rpmF	FALSE	FALSE	TRUE
plsX	FALSE	TRUE	FALSE
fabH	TRUE	FALSE	FALSE
fabD	TRUE	FALSE	FALSE
fabG	TRUE	FALSE	FALSE
acpP	TRUE	FALSE	FALSE
fabF	FALSE	TRUE	FALSE
pabC	FALSE	TRUE	FALSE
yceG	FALSE	TRUE	FALSE
tmk	TRUE	FALSE	FALSE
holB	TRUE	FALSE	FALSE
ycfH	FALSE	TRUE	FALSE
ptsG	FALSE	TRUE	FALSE
fhuE	FALSE	TRUE	FALSE
hinT	FALSE	TRUE	FALSE
ycfL	FALSE	TRUE	FALSE
lpoB	FALSE	TRUE	FALSE
thiK	FALSE	TRUE	FALSE
nagZ	FALSE	TRUE	FALSE
ycfP	FALSE	TRUE	FALSE
ndh	FALSE	FALSE	TRUE
ycfJ	FALSE	TRUE	FALSE
ycfQ	FALSE	TRUE	FALSE
bhsA	FALSE	FALSE	TRUE
ldtC	FALSE	TRUE	FALSE
mfd	FALSE	TRUE	FALSE
ycfT	FALSE	TRUE	FALSE
lolC	TRUE	FALSE	FALSE
lolD	TRUE	FALSE	FALSE
lolE	TRUE	FALSE	FALSE
nagK	FALSE	TRUE	FALSE
cobB	FALSE	TRUE	FALSE
ycfZ	FALSE	TRUE	FALSE
ymfA	FALSE	TRUE	FALSE
potD	FALSE	TRUE	FALSE
potC	FALSE	TRUE	FALSE
potB	FALSE	TRUE	FALSE
potA	FALSE	TRUE	FALSE
pepT	FALSE	TRUE	FALSE
roxA	FALSE	TRUE	FALSE
phoQ	FALSE	TRUE	FALSE
phoP	FALSE	TRUE	FALSE
purB	TRUE	FALSE	FALSE
hflD	FALSE	TRUE	FALSE
mnmA	TRUE	FALSE	FALSE
nudJ	FALSE	TRUE	FALSE
rluE	FALSE	TRUE	FALSE
icd	TRUE	FALSE	FALSE
ymfD	FALSE	FALSE	TRUE
ymfE	TRUE	FALSE	FALSE
lit	FALSE	TRUE	FALSE
intE	FALSE	TRUE	FALSE
xisE	FALSE	TRUE	FALSE
ymfI	FALSE	TRUE	FALSE
ymfJ	FALSE	TRUE	FALSE
cohE	TRUE	FALSE	FALSE
croE	FALSE	TRUE	FALSE
ymfL	FALSE	TRUE	FALSE
ymfM	FALSE	TRUE	FALSE
oweE	FALSE	TRUE	FALSE
aaaE	FALSE	TRUE	FALSE
ymfR	FALSE	TRUE	FALSE
beeE	FALSE	TRUE	FALSE
jayE	FALSE	TRUE	FALSE
ymfQ	FALSE	TRUE	FALSE
stfP	FALSE	TRUE	FALSE
tfaP	FALSE	TRUE	FALSE
tfaE	FALSE	TRUE	FALSE
stfE	FALSE	TRUE	FALSE
pinE	FALSE	TRUE	FALSE
mcrA	FALSE	TRUE	FALSE
icdC	FALSE	TRUE	FALSE
iraM	FALSE	FALSE	TRUE
ycgX	FALSE	TRUE	FALSE
bluR	FALSE	TRUE	FALSE
bluF	FALSE	TRUE	FALSE
ycgZ	FALSE	TRUE	FALSE
ymgA	FALSE	FALSE	TRUE
ariR	TRUE	FALSE	FALSE
ymgC	FALSE	TRUE	FALSE
ycgG	FALSE	TRUE	FALSE
ymgF	FALSE	TRUE	FALSE
ycgH	FALSE	TRUE	FALSE
ymgD	FALSE	TRUE	FALSE
ymgG	FALSE	TRUE	FALSE
ymgI	FALSE	TRUE	FALSE
ymgJ	FALSE	TRUE	FALSE
ycgI	FALSE	TRUE	FALSE
minE	FALSE	TRUE	FALSE
minD	FALSE	TRUE	FALSE
minC	FALSE	TRUE	FALSE
ycgJ	FALSE	TRUE	FALSE
pliG	FALSE	TRUE	FALSE
ycgL	FALSE	TRUE	FALSE
ycgM	FALSE	TRUE	FALSE
ycgN	FALSE	TRUE	FALSE
hlyE	FALSE	TRUE	FALSE
umuD	FALSE	TRUE	FALSE
umuC	FALSE	TRUE	FALSE
dsbB	FALSE	TRUE	FALSE
nhaB	FALSE	TRUE	FALSE
fadR	FALSE	TRUE	FALSE
ycgB	FALSE	TRUE	FALSE
dadA	FALSE	TRUE	FALSE
dadX	FALSE	TRUE	FALSE
cvrA	FALSE	TRUE	FALSE
ldcA	FALSE	TRUE	FALSE
emtA	FALSE	TRUE	FALSE
ycgR	FALSE	TRUE	FALSE
ymgE	FALSE	TRUE	FALSE
ycgY	FALSE	TRUE	FALSE
treA	FALSE	TRUE	FALSE
dhaM	FALSE	TRUE	FALSE
dhaL	FALSE	TRUE	FALSE
dhaK	FALSE	TRUE	FALSE
dhaR	FALSE	TRUE	FALSE
ycgV	FALSE	TRUE	FALSE
ychF	FALSE	FALSE	TRUE
pth	TRUE	FALSE	FALSE
ychH	FALSE	TRUE	FALSE
dauA	FALSE	TRUE	FALSE
prs	TRUE	FALSE	FALSE
ispE	TRUE	FALSE	FALSE
lolB	TRUE	FALSE	FALSE
hemA	TRUE	FALSE	FALSE
prfA	TRUE	FALSE	FALSE
prmC	TRUE	FALSE	FALSE
ychQ	FALSE	TRUE	FALSE
ychA	FALSE	TRUE	FALSE
kdsA	TRUE	FALSE	FALSE
ldrA	FALSE	TRUE	FALSE
ldrB	FALSE	TRUE	FALSE
ldrC	FALSE	TRUE	FALSE
chaA	FALSE	TRUE	FALSE
chaB	FALSE	TRUE	FALSE
chaC	FALSE	TRUE	FALSE
ychN	FALSE	TRUE	FALSE
ychO	FALSE	TRUE	FALSE
narL	FALSE	TRUE	FALSE
narX	FALSE	TRUE	FALSE
narK	FALSE	TRUE	FALSE
narG	FALSE	TRUE	FALSE
narH	FALSE	FALSE	TRUE
narJ	FALSE	TRUE	FALSE
narI	FALSE	TRUE	FALSE
tpr	FALSE	TRUE	FALSE
purU	FALSE	TRUE	FALSE
ychJ	FALSE	TRUE	FALSE
rssA	FALSE	TRUE	FALSE
rssB	FALSE	TRUE	FALSE
galU	FALSE	TRUE	FALSE
hns	FALSE	FALSE	TRUE
tdk	FALSE	TRUE	FALSE
insZ	FALSE	TRUE	FALSE
adhE	FALSE	TRUE	FALSE
ychE	FALSE	TRUE	FALSE
oppA	FALSE	TRUE	FALSE
oppB	FALSE	TRUE	FALSE
oppC	FALSE	TRUE	FALSE
oppD	FALSE	FALSE	TRUE
oppF	FALSE	FALSE	TRUE
yciU	FALSE	FALSE	TRUE
clsA	FALSE	TRUE	FALSE
yciY	FALSE	TRUE	FALSE
kch	FALSE	TRUE	FALSE
yciI	FALSE	TRUE	FALSE
tonB	TRUE	FALSE	FALSE
yciA	FALSE	TRUE	FALSE
yciB	FALSE	TRUE	FALSE
yciC	FALSE	TRUE	FALSE
ompW	FALSE	TRUE	FALSE
yciE	FALSE	TRUE	FALSE
yciF	FALSE	TRUE	FALSE
yciG	FALSE	TRUE	FALSE
trpA	FALSE	TRUE	FALSE
trpB	FALSE	TRUE	FALSE
trpC	FALSE	TRUE	FALSE
trpD	FALSE	TRUE	FALSE
trpE	FALSE	TRUE	FALSE
trpL	FALSE	FALSE	TRUE
yciV	FALSE	TRUE	FALSE
yciO	FALSE	TRUE	FALSE
yciQ	FALSE	TRUE	FALSE
rluB	FALSE	TRUE	FALSE
btuR	FALSE	TRUE	FALSE
yciK	FALSE	TRUE	FALSE
sohB	FALSE	TRUE	FALSE
yciN	FALSE	TRUE	FALSE
topA	TRUE	FALSE	FALSE
cysB	FALSE	TRUE	FALSE
ymiA	FALSE	TRUE	FALSE
yciX	FALSE	TRUE	FALSE
acnA	FALSE	TRUE	FALSE
ribA	TRUE	FALSE	FALSE
pgpB	FALSE	FALSE	TRUE
yciS	TRUE	FALSE	FALSE
yciM	TRUE	FALSE	FALSE
pyrF	FALSE	TRUE	FALSE
yciH	FALSE	TRUE	FALSE
osmB	FALSE	TRUE	FALSE
yciT	FALSE	TRUE	FALSE
yciZ	FALSE	TRUE	FALSE
gmr	FALSE	TRUE	FALSE
ymiB	FALSE	FALSE	TRUE
rnb	FALSE	FALSE	TRUE
yciW	FALSE	TRUE	FALSE
fabI	TRUE	FALSE	FALSE
ycjD	FALSE	TRUE	FALSE
sapF	FALSE	FALSE	TRUE
sapD	FALSE	FALSE	TRUE
sapC	FALSE	TRUE	FALSE
sapB	FALSE	TRUE	FALSE
sapA	FALSE	TRUE	FALSE
ymjA	FALSE	TRUE	FALSE
puuP	FALSE	TRUE	FALSE
puuA	FALSE	TRUE	FALSE
puuD	FALSE	TRUE	FALSE
puuR	FALSE	TRUE	FALSE
puuC	FALSE	TRUE	FALSE
puuB	FALSE	TRUE	FALSE
puuE	FALSE	TRUE	FALSE
pspF	FALSE	TRUE	FALSE
pspA	FALSE	FALSE	TRUE
pspB	FALSE	FALSE	TRUE
pspC	FALSE	TRUE	FALSE
pspD	FALSE	FALSE	TRUE
pspE	FALSE	TRUE	FALSE
ycjM	FALSE	TRUE	FALSE
ycjN	FALSE	TRUE	FALSE
ycjO	FALSE	TRUE	FALSE
ycjP	FALSE	TRUE	FALSE
ycjQ	FALSE	TRUE	FALSE
ycjR	FALSE	TRUE	FALSE
ycjS	FALSE	TRUE	FALSE
ycjT	FALSE	TRUE	FALSE
ycjU	FALSE	TRUE	FALSE
ycjV	FALSE	TRUE	FALSE
ompG	FALSE	TRUE	FALSE
ycjW	FALSE	TRUE	FALSE
ycjX	FALSE	TRUE	FALSE
ycjF	FALSE	TRUE	FALSE
tyrR	FALSE	TRUE	FALSE
tpx	FALSE	TRUE	FALSE
ycjG	FALSE	TRUE	FALSE
mpaA	FALSE	TRUE	FALSE
ymjC	FALSE	TRUE	FALSE
ymjD	FALSE	TRUE	FALSE
ycjY	FALSE	TRUE	FALSE
pgrR	FALSE	TRUE	FALSE
mppA	FALSE	TRUE	FALSE
ynaI	FALSE	TRUE	FALSE
insH1	FALSE	TRUE	FALSE
ynaJ	FALSE	TRUE	FALSE
uspE	FALSE	TRUE	FALSE
fnr	FALSE	FALSE	TRUE
ogt	FALSE	FALSE	TRUE
abgT	FALSE	FALSE	TRUE
abgB	FALSE	TRUE	FALSE
abgA	FALSE	TRUE	FALSE
abgR	FALSE	TRUE	FALSE
smrA	FALSE	TRUE	FALSE
ydaM	FALSE	TRUE	FALSE
ydaN	FALSE	TRUE	FALSE
dbpA	FALSE	TRUE	FALSE
ttcA	FALSE	TRUE	FALSE
intR	FALSE	TRUE	FALSE
ydaQ	FALSE	TRUE	FALSE
rcbA	FALSE	FALSE	TRUE
ralR	FALSE	TRUE	FALSE
recT	FALSE	TRUE	FALSE
recE	FALSE	TRUE	FALSE
racC	FALSE	TRUE	FALSE
ydaE	TRUE	FALSE	FALSE
kilR	FALSE	FALSE	TRUE
sieB	FALSE	TRUE	FALSE
ydaF	FALSE	TRUE	FALSE
ydaG	FALSE	TRUE	FALSE
racR	TRUE	FALSE	FALSE
ydaS	TRUE	FALSE	FALSE
ydaT	FALSE	FALSE	TRUE
ydaU	FALSE	TRUE	FALSE
ydaV	FALSE	TRUE	FALSE
ydaW	FALSE	FALSE	TRUE
rzpR	FALSE	TRUE	FALSE
rzoR	FALSE	TRUE	FALSE
trkG	FALSE	TRUE	FALSE
ynaK	FALSE	TRUE	FALSE
ydaY	FALSE	TRUE	FALSE
tmpR	FALSE	TRUE	FALSE
lomR	FALSE	TRUE	FALSE
insH1	FALSE	TRUE	FALSE
stfR	FALSE	TRUE	FALSE
tfaR	FALSE	TRUE	FALSE
pinR	FALSE	TRUE	FALSE
ynaE	FALSE	TRUE	FALSE
ttcC	TRUE	FALSE	FALSE
uspF	FALSE	TRUE	FALSE
ompN	FALSE	TRUE	FALSE
pfo	FALSE	TRUE	FALSE
ydbJ	FALSE	TRUE	FALSE
hslJ	FALSE	TRUE	FALSE
ldhA	FALSE	TRUE	FALSE
ydbH	FALSE	TRUE	FALSE
ynbE	FALSE	TRUE	FALSE
ydbL	FALSE	TRUE	FALSE
feaR	FALSE	TRUE	FALSE
feaB	FALSE	TRUE	FALSE
tynA	FALSE	TRUE	FALSE
paaZ	FALSE	TRUE	FALSE
paaA	FALSE	TRUE	FALSE
paaB	FALSE	TRUE	FALSE
paaC	FALSE	TRUE	FALSE
paaD	FALSE	TRUE	FALSE
paaE	FALSE	TRUE	FALSE
paaF	FALSE	TRUE	FALSE
paaG	FALSE	TRUE	FALSE
paaH	FALSE	TRUE	FALSE
paaI	FALSE	TRUE	FALSE
paaJ	FALSE	TRUE	FALSE
paaK	FALSE	TRUE	FALSE
paaX	FALSE	TRUE	FALSE
paaY	FALSE	TRUE	FALSE
ynbG	TRUE	FALSE	FALSE
ydbA	FALSE	TRUE	FALSE
insD1	FALSE	TRUE	FALSE
insC1	FALSE	TRUE	FALSE
insI1	FALSE	TRUE	FALSE
ydbC	FALSE	TRUE	FALSE
ydbD	FALSE	TRUE	FALSE
ynbA	FALSE	TRUE	FALSE
ynbB	FALSE	TRUE	FALSE
ynbC	FALSE	TRUE	FALSE
ynbD	FALSE	TRUE	FALSE
azoR	FALSE	TRUE	FALSE
hrpA	FALSE	FALSE	TRUE
ydcF	FALSE	TRUE	FALSE
aldA	FALSE	TRUE	FALSE
gapC	FALSE	TRUE	FALSE
cybB	FALSE	TRUE	FALSE
ydcA	FALSE	TRUE	FALSE
hokB	FALSE	TRUE	FALSE
mokB	FALSE	TRUE	FALSE
trg	FALSE	TRUE	FALSE
ydcI	FALSE	TRUE	FALSE
ydcJ	FALSE	TRUE	FALSE
opgD	FALSE	TRUE	FALSE
ydcH	FALSE	FALSE	TRUE
rimL	FALSE	TRUE	FALSE
ydcK	FALSE	TRUE	FALSE
tehA	FALSE	TRUE	FALSE
tehB	FALSE	TRUE	FALSE
ydcL	FALSE	TRUE	FALSE
insP	FALSE	TRUE	FALSE
insQ	FALSE	TRUE	FALSE
ydcO	FALSE	TRUE	FALSE
ydcN	FALSE	FALSE	TRUE
ydcP	FALSE	TRUE	FALSE
yncJ	FALSE	TRUE	FALSE
hicA	FALSE	TRUE	FALSE
hicB	FALSE	FALSE	TRUE
ydcR	FALSE	TRUE	FALSE
ydcS	FALSE	TRUE	FALSE
ydcT	FALSE	TRUE	FALSE
ydcU	FALSE	TRUE	FALSE
ydcV	FALSE	TRUE	FALSE
patD	FALSE	TRUE	FALSE
yncL	FALSE	TRUE	FALSE
ydcX	FALSE	FALSE	TRUE
ydcY	FALSE	TRUE	FALSE
ydcZ	FALSE	TRUE	FALSE
mnaT	FALSE	TRUE	FALSE
curA	FALSE	TRUE	FALSE
mcbR	FALSE	TRUE	FALSE
yncD	FALSE	TRUE	FALSE
yncE	FALSE	TRUE	FALSE
ansP	FALSE	TRUE	FALSE
yncG	FALSE	TRUE	FALSE
yncH	TRUE	FALSE	FALSE
rhsE	FALSE	TRUE	FALSE
ydcD	TRUE	FALSE	FALSE
yncI	FALSE	FALSE	TRUE
ydcC	FALSE	TRUE	FALSE
pptA	FALSE	TRUE	FALSE
yddH	FALSE	TRUE	FALSE
nhoA	FALSE	TRUE	FALSE
yddE	FALSE	TRUE	FALSE
narV	FALSE	TRUE	FALSE
narW	FALSE	TRUE	FALSE
narY	FALSE	TRUE	FALSE
narZ	FALSE	TRUE	FALSE
narU	FALSE	TRUE	FALSE
yddK	FALSE	FALSE	TRUE
yddL	TRUE	FALSE	FALSE
yddG	FALSE	TRUE	FALSE
fdnG	FALSE	TRUE	FALSE
fdnH	FALSE	TRUE	FALSE
fdnI	FALSE	FALSE	TRUE
yddM	FALSE	FALSE	TRUE
adhP	FALSE	TRUE	FALSE
maeA	FALSE	TRUE	FALSE
sra	FALSE	TRUE	FALSE
bdm	FALSE	TRUE	FALSE
osmC	FALSE	TRUE	FALSE
ddpF	FALSE	TRUE	FALSE
ddpD	FALSE	TRUE	FALSE
ddpC	FALSE	TRUE	FALSE
ddpB	FALSE	TRUE	FALSE
ddpA	FALSE	TRUE	FALSE
ddpX	FALSE	TRUE	FALSE
dosP	FALSE	TRUE	FALSE
dosC	FALSE	TRUE	FALSE
yddW	FALSE	TRUE	FALSE
gadC	FALSE	TRUE	FALSE
gadB	FALSE	TRUE	FALSE
pqqL	FALSE	TRUE	FALSE
yddB	FALSE	TRUE	FALSE
yddA	FALSE	TRUE	FALSE
ydeM	FALSE	TRUE	FALSE
ydeN	FALSE	TRUE	FALSE
ydeO	FALSE	FALSE	TRUE
safA	TRUE	FALSE	FALSE
ydeP	FALSE	TRUE	FALSE
ydeQ	FALSE	TRUE	FALSE
ydeR	FALSE	TRUE	FALSE
ydeS	FALSE	TRUE	FALSE
ydeT	FALSE	TRUE	FALSE
yneL	FALSE	TRUE	FALSE
hipA	FALSE	FALSE	TRUE
hipB	TRUE	FALSE	FALSE
yneO	FALSE	TRUE	FALSE
lsrK	FALSE	TRUE	FALSE
lsrR	FALSE	TRUE	FALSE
lsrA	FALSE	TRUE	FALSE
lsrC	FALSE	TRUE	FALSE
lsrD	FALSE	TRUE	FALSE
lsrB	FALSE	TRUE	FALSE
lsrF	FALSE	TRUE	FALSE
lsrG	FALSE	FALSE	TRUE
tam	FALSE	TRUE	FALSE
yneE	FALSE	FALSE	TRUE
uxaB	FALSE	TRUE	FALSE
yneF	FALSE	FALSE	TRUE
yneG	FALSE	FALSE	TRUE
glsB	FALSE	TRUE	FALSE
sad	FALSE	FALSE	TRUE
yneJ	FALSE	TRUE	FALSE
yneK	FALSE	TRUE	FALSE
ydeA	FALSE	TRUE	FALSE
marC	FALSE	TRUE	FALSE
marR	FALSE	TRUE	FALSE
marA	FALSE	TRUE	FALSE
marB	FALSE	FALSE	TRUE
eamA	FALSE	TRUE	FALSE
ydeE	FALSE	TRUE	FALSE
yneM	FALSE	TRUE	FALSE
dgcZ	FALSE	TRUE	FALSE
ydeI	FALSE	TRUE	FALSE
ydeJ	FALSE	TRUE	FALSE
dcp	FALSE	TRUE	FALSE
ydfG	FALSE	TRUE	FALSE
rspR	FALSE	FALSE	TRUE
ydfZ	FALSE	TRUE	FALSE
ydfI	FALSE	TRUE	FALSE
ydfJ	FALSE	TRUE	FALSE
ydfK	FALSE	FALSE	TRUE
pinQ	FALSE	TRUE	FALSE
tfaQ	FALSE	TRUE	FALSE
stfQ	FALSE	TRUE	FALSE
nohQ	FALSE	TRUE	FALSE
ynfO	FALSE	TRUE	FALSE
ydfO	TRUE	FALSE	FALSE
gnsB	TRUE	FALSE	FALSE
ynfN	TRUE	FALSE	FALSE
cspI	FALSE	FALSE	TRUE
rzpQ	FALSE	FALSE	TRUE
rzoQ	FALSE	TRUE	FALSE
rrrQ	FALSE	TRUE	FALSE
ydfR	FALSE	FALSE	TRUE
essQ	FALSE	TRUE	FALSE
cspB	FALSE	TRUE	FALSE
cspF	FALSE	TRUE	FALSE
quuQ	FALSE	TRUE	FALSE
ydfU	FALSE	TRUE	FALSE
rem	FALSE	TRUE	FALSE
hokD	FALSE	TRUE	FALSE
relE	FALSE	TRUE	FALSE
relB	TRUE	FALSE	FALSE
ydfV	FALSE	TRUE	FALSE
flxA	FALSE	TRUE	FALSE
intK	FALSE	TRUE	FALSE
ydfX	FALSE	TRUE	FALSE
dicC	FALSE	FALSE	TRUE
dicA	TRUE	FALSE	FALSE
ydfA	FALSE	FALSE	TRUE
ydfB	FALSE	FALSE	TRUE
ydfC	FALSE	TRUE	FALSE
dicB	FALSE	TRUE	FALSE
ydfD	FALSE	TRUE	FALSE
ydfE	FALSE	TRUE	FALSE
insD1	FALSE	TRUE	FALSE
intQ	FALSE	TRUE	FALSE
rspB	FALSE	TRUE	FALSE
rspA	FALSE	TRUE	FALSE
ynfA	FALSE	TRUE	FALSE
ynfB	FALSE	TRUE	FALSE
speG	FALSE	TRUE	FALSE
ynfC	FALSE	TRUE	FALSE
ynfD	FALSE	TRUE	FALSE
ynfE	FALSE	TRUE	FALSE
ynfF	FALSE	TRUE	FALSE
ynfG	FALSE	TRUE	FALSE
ynfH	FALSE	TRUE	FALSE
dmsD	FALSE	TRUE	FALSE
clcB	FALSE	TRUE	FALSE
ynfK	FALSE	TRUE	FALSE
mlc	FALSE	FALSE	TRUE
ynfL	FALSE	TRUE	FALSE
ynfM	FALSE	TRUE	FALSE
asr	FALSE	TRUE	FALSE
ydgU	FALSE	TRUE	FALSE
ydgD	FALSE	TRUE	FALSE
mdtI	FALSE	TRUE	FALSE
mdtJ	FALSE	TRUE	FALSE
tqsA	FALSE	TRUE	FALSE
pntB	FALSE	TRUE	FALSE
pntA	FALSE	TRUE	FALSE
ydgH	FALSE	TRUE	FALSE
ydgI	FALSE	TRUE	FALSE
folM	FALSE	TRUE	FALSE
ydgC	FALSE	TRUE	FALSE
rstA	FALSE	TRUE	FALSE
rstB	FALSE	TRUE	FALSE
tus	FALSE	TRUE	FALSE
fumC	FALSE	TRUE	FALSE
fumA	FALSE	TRUE	FALSE
manA	FALSE	FALSE	TRUE
ydgA	FALSE	TRUE	FALSE
uidC	FALSE	TRUE	FALSE
uidB	FALSE	TRUE	FALSE
uidA	FALSE	TRUE	FALSE
uidR	FALSE	TRUE	FALSE
hdhA	FALSE	TRUE	FALSE
malI	FALSE	TRUE	FALSE
malX	FALSE	TRUE	FALSE
malY	FALSE	TRUE	FALSE
add	FALSE	TRUE	FALSE
ydgJ	FALSE	TRUE	FALSE
blr	FALSE	TRUE	FALSE
cnu	FALSE	TRUE	FALSE
ydgK	FALSE	TRUE	FALSE
rsxA	FALSE	TRUE	FALSE
rsxB	FALSE	TRUE	FALSE
rsxC	FALSE	TRUE	FALSE
rsxD	FALSE	TRUE	FALSE
rsxG	FALSE	TRUE	FALSE
rsxE	FALSE	TRUE	FALSE
nth	FALSE	TRUE	FALSE
dtpA	FALSE	TRUE	FALSE
gstA	FALSE	TRUE	FALSE
pdxY	FALSE	TRUE	FALSE
tyrS	TRUE	FALSE	FALSE
pdxH	TRUE	FALSE	FALSE
mliC	FALSE	TRUE	FALSE
anmK	FALSE	TRUE	FALSE
slyB	FALSE	TRUE	FALSE
slyA	FALSE	TRUE	FALSE
ydhI	FALSE	TRUE	FALSE
ydhJ	FALSE	TRUE	FALSE
ydhK	FALSE	TRUE	FALSE
sodC	FALSE	TRUE	FALSE
ydhF	FALSE	TRUE	FALSE
ydhL	FALSE	FALSE	TRUE
nemR	FALSE	FALSE	TRUE
nemA	FALSE	TRUE	FALSE
gloA	FALSE	TRUE	FALSE
rnt	TRUE	FALSE	FALSE
lhr	FALSE	TRUE	FALSE
grxD	FALSE	FALSE	TRUE
mepH	FALSE	TRUE	FALSE
sodB	FALSE	TRUE	FALSE
ydhP	FALSE	TRUE	FALSE
ynhF	FALSE	FALSE	TRUE
purR	FALSE	TRUE	FALSE
ydhB	FALSE	FALSE	TRUE
ydhC	FALSE	TRUE	FALSE
cfa	FALSE	TRUE	FALSE
ribC	TRUE	FALSE	FALSE
mdtK	FALSE	TRUE	FALSE
ydhQ	FALSE	TRUE	FALSE
ydhR	FALSE	FALSE	TRUE
ydhS	FALSE	TRUE	FALSE
ydhT	FALSE	TRUE	FALSE
ydhU	FALSE	FALSE	TRUE
ydhX	FALSE	FALSE	TRUE
ydhW	FALSE	TRUE	FALSE
ydhV	FALSE	TRUE	FALSE
ydhY	FALSE	TRUE	FALSE
ydhZ	FALSE	TRUE	FALSE
pykF	FALSE	TRUE	FALSE
lpp	FALSE	FALSE	TRUE
ldtE	FALSE	TRUE	FALSE
sufE	FALSE	TRUE	FALSE
sufS	FALSE	TRUE	FALSE
sufD	FALSE	TRUE	FALSE
sufC	FALSE	TRUE	FALSE
sufB	FALSE	TRUE	FALSE
sufA	FALSE	TRUE	FALSE
ydiH	TRUE	FALSE	FALSE
menI	FALSE	FALSE	TRUE
ydiJ	FALSE	TRUE	FALSE
ydiK	FALSE	TRUE	FALSE
ydiL	FALSE	TRUE	FALSE
ydiM	FALSE	TRUE	FALSE
ydiN	FALSE	TRUE	FALSE
ydiB	FALSE	TRUE	FALSE
aroD	FALSE	TRUE	FALSE
ydiF	FALSE	TRUE	FALSE
ydiO	FALSE	TRUE	FALSE
ydiP	FALSE	TRUE	FALSE
ydiQ	FALSE	TRUE	FALSE
ydiR	FALSE	TRUE	FALSE
ydiS	FALSE	FALSE	TRUE
ydiT	FALSE	TRUE	FALSE
fadK	FALSE	TRUE	FALSE
ppsA	FALSE	TRUE	FALSE
ppsR	FALSE	TRUE	FALSE
aroH	FALSE	TRUE	FALSE
ydiE	FALSE	TRUE	FALSE
ydiU	FALSE	TRUE	FALSE
ydiV	FALSE	TRUE	FALSE
nlpC	FALSE	TRUE	FALSE
btuD	FALSE	TRUE	FALSE
btuE	FALSE	TRUE	FALSE
btuC	FALSE	TRUE	FALSE
ihfA	TRUE	FALSE	FALSE
pheT	TRUE	FALSE	FALSE
pheS	TRUE	FALSE	FALSE
pheM	TRUE	FALSE	FALSE
rplT	TRUE	FALSE	FALSE
rpmI	TRUE	FALSE	FALSE
infC	TRUE	FALSE	FALSE
thrS	TRUE	FALSE	FALSE
arpB	FALSE	TRUE	FALSE
yniD	FALSE	TRUE	FALSE
ydiY	FALSE	TRUE	FALSE
pfkB	FALSE	TRUE	FALSE
ydiZ	FALSE	TRUE	FALSE
yniA	FALSE	TRUE	FALSE
yniB	FALSE	TRUE	FALSE
yniC	FALSE	TRUE	FALSE
ydjM	FALSE	TRUE	FALSE
ydjN	FALSE	TRUE	FALSE
ydjO	FALSE	FALSE	TRUE
cedA	FALSE	TRUE	FALSE
katE	FALSE	TRUE	FALSE
chbG	FALSE	TRUE	FALSE
chbF	FALSE	TRUE	FALSE
chbR	FALSE	TRUE	FALSE
chbA	FALSE	TRUE	FALSE
chbC	FALSE	TRUE	FALSE
chbB	FALSE	TRUE	FALSE
osmE	FALSE	TRUE	FALSE
nadE	TRUE	FALSE	FALSE
cho	FALSE	TRUE	FALSE
ves	FALSE	FALSE	TRUE
spy	FALSE	TRUE	FALSE
astE	FALSE	TRUE	FALSE
astB	FALSE	TRUE	FALSE
astD	FALSE	TRUE	FALSE
astA	FALSE	TRUE	FALSE
astC	FALSE	TRUE	FALSE
xthA	FALSE	TRUE	FALSE
ydjX	FALSE	TRUE	FALSE
ydjY	FALSE	TRUE	FALSE
ydjZ	FALSE	TRUE	FALSE
ynjA	FALSE	FALSE	TRUE
ynjB	FALSE	TRUE	FALSE
ynjC	FALSE	TRUE	FALSE
ynjD	FALSE	TRUE	FALSE
ynjE	FALSE	TRUE	FALSE
ynjF	FALSE	FALSE	TRUE
nudG	FALSE	TRUE	FALSE
ynjH	FALSE	TRUE	FALSE
gdhA	FALSE	TRUE	FALSE
ynjI	FALSE	TRUE	FALSE
topB	FALSE	TRUE	FALSE
selD	FALSE	TRUE	FALSE
ydjA	FALSE	TRUE	FALSE
sppA	FALSE	TRUE	FALSE
ansA	FALSE	TRUE	FALSE
pncA	FALSE	TRUE	FALSE
ydjE	FALSE	TRUE	FALSE
ydjF	FALSE	TRUE	FALSE
ydjG	FALSE	TRUE	FALSE
ydjH	FALSE	TRUE	FALSE
ydjI	FALSE	TRUE	FALSE
ydjJ	FALSE	TRUE	FALSE
ydjK	FALSE	TRUE	FALSE
ydjL	FALSE	TRUE	FALSE
yeaC	FALSE	TRUE	FALSE
msrB	FALSE	FALSE	TRUE
gapA	TRUE	FALSE	FALSE
yeaD	FALSE	TRUE	FALSE
yeaE	FALSE	TRUE	FALSE
mipA	FALSE	TRUE	FALSE
yeaG	FALSE	TRUE	FALSE
yeaH	FALSE	TRUE	FALSE
yeaI	FALSE	TRUE	FALSE
yeaJ	FALSE	TRUE	FALSE
yeaK	FALSE	TRUE	FALSE
yoaI	FALSE	TRUE	FALSE
yeaL	FALSE	TRUE	FALSE
yeaM	FALSE	TRUE	FALSE
yeaN	FALSE	TRUE	FALSE
yeaO	FALSE	TRUE	FALSE
yoaF	FALSE	TRUE	FALSE
yeaP	FALSE	TRUE	FALSE
yoaK	FALSE	TRUE	FALSE
yoaJ	FALSE	TRUE	FALSE
yeaQ	FALSE	TRUE	FALSE
yoaG	FALSE	TRUE	FALSE
yeaR	FALSE	TRUE	FALSE
leuE	FALSE	TRUE	FALSE
dmlR	FALSE	TRUE	FALSE
dmlA	FALSE	TRUE	FALSE
yeaV	FALSE	TRUE	FALSE
yeaW	FALSE	TRUE	FALSE
yeaX	FALSE	TRUE	FALSE
rnd	FALSE	FALSE	TRUE
fadD	FALSE	TRUE	FALSE
yeaY	FALSE	TRUE	FALSE
tsaB	TRUE	FALSE	FALSE
yoaA	FALSE	TRUE	FALSE
yoaB	FALSE	TRUE	FALSE
yoaC	FALSE	TRUE	FALSE
yoaH	FALSE	TRUE	FALSE
pabB	FALSE	TRUE	FALSE
nudL	FALSE	TRUE	FALSE
sdaA	FALSE	TRUE	FALSE
yoaD	FALSE	TRUE	FALSE
yoaE	FALSE	TRUE	FALSE
manX	FALSE	TRUE	FALSE
manY	FALSE	TRUE	FALSE
manZ	FALSE	TRUE	FALSE
yobD	FALSE	TRUE	FALSE
mntP	FALSE	TRUE	FALSE
rlmA	FALSE	TRUE	FALSE
cspC	FALSE	TRUE	FALSE
yobF	FALSE	TRUE	FALSE
yebO	FALSE	TRUE	FALSE
mgrB	FALSE	FALSE	TRUE
yobH	FALSE	TRUE	FALSE
kdgR	FALSE	TRUE	FALSE
yebQ	FALSE	TRUE	FALSE
htpX	FALSE	TRUE	FALSE
prc	FALSE	TRUE	FALSE
proQ	FALSE	FALSE	TRUE
msrC	FALSE	TRUE	FALSE
yebS	FALSE	TRUE	FALSE
yebT	FALSE	TRUE	FALSE
rsmF	FALSE	TRUE	FALSE
yebV	FALSE	TRUE	FALSE
yebW	FALSE	TRUE	FALSE
pphA	FALSE	TRUE	FALSE
yebY	FALSE	TRUE	FALSE
yebZ	FALSE	TRUE	FALSE
yobA	FALSE	TRUE	FALSE
holE	FALSE	TRUE	FALSE
yobB	FALSE	TRUE	FALSE
exoX	FALSE	TRUE	FALSE
ptrB	FALSE	TRUE	FALSE
yebE	FALSE	TRUE	FALSE
yebF	FALSE	FALSE	TRUE
yebG	FALSE	FALSE	TRUE
purT	FALSE	TRUE	FALSE
eda	FALSE	TRUE	FALSE
edd	FALSE	TRUE	FALSE
zwf	TRUE	FALSE	FALSE
yebK	FALSE	TRUE	FALSE
pykA	FALSE	TRUE	FALSE
lpxM	FALSE	TRUE	FALSE
mepM	FALSE	TRUE	FALSE
znuA	FALSE	TRUE	FALSE
znuC	FALSE	TRUE	FALSE
znuB	FALSE	TRUE	FALSE
ruvB	FALSE	FALSE	TRUE
ruvA	FALSE	TRUE	FALSE
yobI	FALSE	FALSE	TRUE
yebB	FALSE	TRUE	FALSE
ruvC	FALSE	TRUE	FALSE
yebC	FALSE	TRUE	FALSE
nudB	FALSE	FALSE	TRUE
aspS	TRUE	FALSE	FALSE
yecD	FALSE	TRUE	FALSE
yecE	FALSE	TRUE	FALSE
yecN	FALSE	TRUE	FALSE
cmoA	FALSE	TRUE	FALSE
cmoB	FALSE	TRUE	FALSE
torZ	FALSE	TRUE	FALSE
torY	FALSE	TRUE	FALSE
cutC	FALSE	TRUE	FALSE
yecM	FALSE	TRUE	FALSE
argS	TRUE	FALSE	FALSE
yecT	FALSE	TRUE	FALSE
flhE	FALSE	TRUE	FALSE
flhA	FALSE	TRUE	FALSE
flhB	FALSE	TRUE	FALSE
cheZ	FALSE	TRUE	FALSE
cheY	FALSE	TRUE	FALSE
cheB	FALSE	TRUE	FALSE
cheR	FALSE	TRUE	FALSE
tap	FALSE	TRUE	FALSE
tar	FALSE	TRUE	FALSE
cheW	FALSE	TRUE	FALSE
cheA	FALSE	TRUE	FALSE
motB	FALSE	TRUE	FALSE
motA	FALSE	TRUE	FALSE
flhC	FALSE	TRUE	FALSE
flhD	FALSE	TRUE	FALSE
uspC	FALSE	TRUE	FALSE
otsA	FALSE	TRUE	FALSE
otsB	FALSE	TRUE	FALSE
araH	FALSE	TRUE	FALSE
araG	FALSE	TRUE	FALSE
araF	FALSE	TRUE	FALSE
ftnB	FALSE	TRUE	FALSE
yecJ	FALSE	TRUE	FALSE
azuC	FALSE	FALSE	TRUE
yecR	FALSE	TRUE	FALSE
ftnA	FALSE	TRUE	FALSE
yecH	FALSE	TRUE	FALSE
tyrP	FALSE	TRUE	FALSE
yecA	FALSE	TRUE	FALSE
pgsA	TRUE	FALSE	FALSE
uvrC	FALSE	TRUE	FALSE
uvrY	FALSE	TRUE	FALSE
yecF	FALSE	TRUE	FALSE
sdiA	FALSE	TRUE	FALSE
yecC	FALSE	TRUE	FALSE
yecS	FALSE	TRUE	FALSE
dcyD	FALSE	TRUE	FALSE
fliY	FALSE	TRUE	FALSE
fliZ	FALSE	TRUE	FALSE
fliA	FALSE	TRUE	FALSE
fliC	FALSE	TRUE	FALSE
fliD	FALSE	TRUE	FALSE
fliS	FALSE	TRUE	FALSE
fliT	FALSE	TRUE	FALSE
amyA	FALSE	TRUE	FALSE
yedD	FALSE	TRUE	FALSE
yedE	FALSE	TRUE	FALSE
yedF	FALSE	TRUE	FALSE
yedK	FALSE	TRUE	FALSE
yedL	FALSE	TRUE	FALSE
yedN	TRUE	FALSE	FALSE
intG	FALSE	TRUE	FALSE
fliE	FALSE	TRUE	FALSE
fliF	FALSE	TRUE	FALSE
fliG	FALSE	TRUE	FALSE
fliH	FALSE	TRUE	FALSE
fliI	FALSE	TRUE	FALSE
fliJ	FALSE	TRUE	FALSE
fliK	FALSE	TRUE	FALSE
fliL	FALSE	TRUE	FALSE
fliM	FALSE	TRUE	FALSE
fliN	FALSE	TRUE	FALSE
fliO	FALSE	TRUE	FALSE
fliP	FALSE	TRUE	FALSE
fliQ	FALSE	TRUE	FALSE
fliR	FALSE	TRUE	FALSE
rcsA	FALSE	TRUE	FALSE
dsrB	FALSE	TRUE	FALSE
yodD	FALSE	TRUE	FALSE
yedP	FALSE	TRUE	FALSE
yedQ	FALSE	TRUE	FALSE
yodC	FALSE	TRUE	FALSE
yedI	FALSE	TRUE	FALSE
yedA	FALSE	TRUE	FALSE
vsr	FALSE	TRUE	FALSE
dcm	FALSE	TRUE	FALSE
yedJ	FALSE	TRUE	FALSE
yedR	FALSE	TRUE	FALSE
yedS	FALSE	TRUE	FALSE
hchA	FALSE	TRUE	FALSE
yedV	FALSE	TRUE	FALSE
yedW	FALSE	TRUE	FALSE
hiuH	FALSE	TRUE	FALSE
yedY	FALSE	TRUE	FALSE
yedZ	FALSE	TRUE	FALSE
zinT	FALSE	TRUE	FALSE
yodB	FALSE	TRUE	FALSE
mtfA	FALSE	TRUE	FALSE
yeeJ	FALSE	TRUE	FALSE
yeeL	FALSE	TRUE	FALSE
shiA	FALSE	TRUE	FALSE
amn	FALSE	TRUE	FALSE
yeeN	FALSE	TRUE	FALSE
yeeO	FALSE	TRUE	FALSE
cbl	FALSE	TRUE	FALSE
nac	FALSE	TRUE	FALSE
ldtA	FALSE	TRUE	FALSE
cobT	FALSE	TRUE	FALSE
cobS	FALSE	TRUE	FALSE
cobU	FALSE	TRUE	FALSE
yeeH	FALSE	TRUE	FALSE
insH1	FALSE	TRUE	FALSE
yoeG	FALSE	TRUE	FALSE
yoeH	FALSE	TRUE	FALSE
yoeA	FALSE	TRUE	FALSE
insD1	FALSE	TRUE	FALSE
insC1	FALSE	TRUE	FALSE
yeeP	FALSE	TRUE	FALSE
flu	FALSE	TRUE	FALSE
yeeR	FALSE	TRUE	FALSE
yeeS	FALSE	TRUE	FALSE
yeeT	FALSE	TRUE	FALSE
cbeA	FALSE	TRUE	FALSE
cbtA	FALSE	TRUE	FALSE
yeeW	FALSE	TRUE	FALSE
yoeD	FALSE	TRUE	FALSE
yoeF	FALSE	TRUE	FALSE
yeeX	FALSE	TRUE	FALSE
yeeA	FALSE	TRUE	FALSE
sbmC	FALSE	TRUE	FALSE
dacD	FALSE	TRUE	FALSE
sbcB	FALSE	TRUE	FALSE
yeeD	FALSE	TRUE	FALSE
yeeE	FALSE	TRUE	FALSE
plaP	FALSE	TRUE	FALSE
yoeI	FALSE	TRUE	FALSE
yeeY	FALSE	TRUE	FALSE
yeeZ	FALSE	TRUE	FALSE
yoeB	FALSE	TRUE	FALSE
yefM	FALSE	FALSE	TRUE
hisL	FALSE	TRUE	FALSE
hisG	FALSE	TRUE	FALSE
hisD	FALSE	TRUE	FALSE
hisC	FALSE	TRUE	FALSE
hisB	FALSE	TRUE	FALSE
hisH	FALSE	TRUE	FALSE
hisA	FALSE	TRUE	FALSE
hisF	FALSE	TRUE	FALSE
hisI	FALSE	TRUE	FALSE
wzzB	FALSE	TRUE	FALSE
ugd	FALSE	TRUE	FALSE
gnd	FALSE	TRUE	FALSE
wbbL	FALSE	TRUE	FALSE
insH1	FALSE	TRUE	FALSE
wbbK	FALSE	TRUE	FALSE
wbbJ	FALSE	TRUE	FALSE
wbbI	FALSE	TRUE	FALSE
wbbH	FALSE	TRUE	FALSE
glf	FALSE	TRUE	FALSE
wzxB	FALSE	TRUE	FALSE
rfbC	FALSE	TRUE	FALSE
rfbA	FALSE	TRUE	FALSE
rfbD	FALSE	TRUE	FALSE
rfbB	FALSE	TRUE	FALSE
wcaN	FALSE	TRUE	FALSE
wcaM	FALSE	TRUE	FALSE
wcaL	FALSE	TRUE	FALSE
wcaK	FALSE	TRUE	FALSE
wzxC	FALSE	TRUE	FALSE
wcaJ	FALSE	TRUE	FALSE
cpsG	FALSE	TRUE	FALSE
cpsB	FALSE	TRUE	FALSE
wcaI	FALSE	TRUE	FALSE
wcaH	FALSE	TRUE	FALSE
wcaG	FALSE	TRUE	FALSE
gmd	FALSE	TRUE	FALSE
wcaF	FALSE	TRUE	FALSE
wcaE	FALSE	TRUE	FALSE
wcaD	FALSE	TRUE	FALSE
wcaC	FALSE	TRUE	FALSE
wcaB	FALSE	TRUE	FALSE
wcaA	FALSE	TRUE	FALSE
wzc	FALSE	TRUE	FALSE
wzb	FALSE	TRUE	FALSE
wza	FALSE	TRUE	FALSE
yegH	FALSE	TRUE	FALSE
asmA	FALSE	TRUE	FALSE
dcd	TRUE	FALSE	FALSE
udk	FALSE	TRUE	FALSE
yegE	FALSE	TRUE	FALSE
alkA	FALSE	TRUE	FALSE
yegD	FALSE	TRUE	FALSE
yegI	FALSE	TRUE	FALSE
yegJ	FALSE	TRUE	FALSE
yegK	FALSE	TRUE	FALSE
yegL	FALSE	TRUE	FALSE
ibsA	FALSE	TRUE	FALSE
ibsB	FALSE	TRUE	FALSE
mdtA	FALSE	TRUE	FALSE
mdtB	FALSE	TRUE	FALSE
mdtC	FALSE	TRUE	FALSE
mdtD	FALSE	TRUE	FALSE
baeS	FALSE	TRUE	FALSE
baeR	FALSE	TRUE	FALSE
yegP	FALSE	TRUE	FALSE
yegQ	FALSE	TRUE	FALSE
ogrK	FALSE	TRUE	FALSE
yegZ	FALSE	TRUE	FALSE
yegR	FALSE	TRUE	FALSE
yegS	FALSE	TRUE	FALSE
gatR	FALSE	TRUE	FALSE
insE1	FALSE	TRUE	FALSE
insF1	FALSE	TRUE	FALSE
gatD	FALSE	TRUE	FALSE
gatC	FALSE	TRUE	FALSE
gatB	FALSE	TRUE	FALSE
gatA	FALSE	TRUE	FALSE
gatZ	FALSE	TRUE	FALSE
gatY	FALSE	TRUE	FALSE
fbaB	FALSE	TRUE	FALSE
yegT	FALSE	TRUE	FALSE
yegU	FALSE	TRUE	FALSE
yegV	FALSE	TRUE	FALSE
yegW	FALSE	TRUE	FALSE
yegX	FALSE	TRUE	FALSE
thiD	FALSE	TRUE	FALSE
thiM	FALSE	TRUE	FALSE
rcnR	FALSE	TRUE	FALSE
rcnA	FALSE	TRUE	FALSE
rcnB	FALSE	TRUE	FALSE
yehA	FALSE	TRUE	FALSE
yehB	FALSE	TRUE	FALSE
yehC	FALSE	FALSE	TRUE
yehD	FALSE	TRUE	FALSE
yehE	FALSE	TRUE	FALSE
mrp	FALSE	TRUE	FALSE
metG	TRUE	FALSE	FALSE
yehH	FALSE	TRUE	FALSE
yehI	FALSE	TRUE	FALSE
yehK	FALSE	TRUE	FALSE
yehL	FALSE	TRUE	FALSE
yehM	FALSE	TRUE	FALSE
yehP	FALSE	TRUE	FALSE
yehQ	FALSE	TRUE	FALSE
yehR	FALSE	TRUE	FALSE
yehS	FALSE	TRUE	FALSE
yehT	FALSE	TRUE	FALSE
yehU	FALSE	TRUE	FALSE
mlrA	FALSE	TRUE	FALSE
yohO	FALSE	TRUE	FALSE
yehW	FALSE	TRUE	FALSE
yehX	FALSE	TRUE	FALSE
yehY	FALSE	TRUE	FALSE
osmF	FALSE	TRUE	FALSE
bglX	FALSE	TRUE	FALSE
dld	FALSE	TRUE	FALSE
pbpG	FALSE	TRUE	FALSE
yohC	FALSE	TRUE	FALSE
yohD	FALSE	TRUE	FALSE
yohF	FALSE	TRUE	FALSE
mdtQ	FALSE	TRUE	FALSE
yohP	FALSE	TRUE	FALSE
dusC	FALSE	TRUE	FALSE
yohJ	FALSE	TRUE	FALSE
yohK	FALSE	TRUE	FALSE
cdd	FALSE	TRUE	FALSE
sanA	FALSE	TRUE	FALSE
yeiS	FALSE	TRUE	FALSE
preT	FALSE	TRUE	FALSE
preA	FALSE	TRUE	FALSE
mglC	FALSE	TRUE	FALSE
mglA	FALSE	TRUE	FALSE
mglB	FALSE	TRUE	FALSE
galS	FALSE	TRUE	FALSE
yeiB	FALSE	TRUE	FALSE
folE	TRUE	FALSE	FALSE
yeiG	FALSE	TRUE	FALSE
cirA	FALSE	TRUE	FALSE
lysP	FALSE	TRUE	FALSE
yeiE	FALSE	TRUE	FALSE
yeiH	FALSE	TRUE	FALSE
nfo	FALSE	TRUE	FALSE
yeiI	FALSE	TRUE	FALSE
nupX	FALSE	TRUE	FALSE
rihB	FALSE	TRUE	FALSE
yeiL	FALSE	TRUE	FALSE
psuT	FALSE	TRUE	FALSE
psuG	FALSE	TRUE	FALSE
psuK	FALSE	TRUE	FALSE
fruA	FALSE	TRUE	FALSE
fruK	FALSE	FALSE	TRUE
fruB	FALSE	TRUE	FALSE
setB	FALSE	TRUE	FALSE
yeiW	FALSE	TRUE	FALSE
yeiP	FALSE	TRUE	FALSE
yeiQ	FALSE	TRUE	FALSE
yeiR	FALSE	TRUE	FALSE
lpxT	FALSE	TRUE	FALSE
mepS	FALSE	TRUE	FALSE
rtn	FALSE	TRUE	FALSE
yejA	FALSE	TRUE	FALSE
yejB	FALSE	TRUE	FALSE
yejE	FALSE	TRUE	FALSE
yejF	FALSE	TRUE	FALSE
yejG	FALSE	TRUE	FALSE
bcr	FALSE	TRUE	FALSE
rsuA	FALSE	TRUE	FALSE
yejH	FALSE	TRUE	FALSE
rplY	TRUE	FALSE	FALSE
yejK	FALSE	TRUE	FALSE
yejL	FALSE	TRUE	FALSE
yejM	FALSE	FALSE	TRUE
yejO	FALSE	TRUE	FALSE
insH1	FALSE	TRUE	FALSE
narP	FALSE	TRUE	FALSE
ccmH	FALSE	TRUE	FALSE
dsbE	FALSE	TRUE	FALSE
ccmF	FALSE	TRUE	FALSE
ccmE	FALSE	TRUE	FALSE
ccmD	FALSE	TRUE	FALSE
ccmC	FALSE	TRUE	FALSE
ccmB	FALSE	TRUE	FALSE
ccmA	FALSE	TRUE	FALSE
napC	FALSE	TRUE	FALSE
napB	FALSE	TRUE	FALSE
napH	FALSE	TRUE	FALSE
napG	FALSE	TRUE	FALSE
napA	FALSE	TRUE	FALSE
napD	FALSE	TRUE	FALSE
napF	FALSE	TRUE	FALSE
eco	FALSE	TRUE	FALSE
mqo	FALSE	TRUE	FALSE
yojI	FALSE	TRUE	FALSE
alkB	FALSE	TRUE	FALSE
ada	FALSE	TRUE	FALSE
apbE	FALSE	TRUE	FALSE
ompC	FALSE	TRUE	FALSE
rcsD	FALSE	TRUE	FALSE
rcsB	FALSE	TRUE	FALSE
rcsC	FALSE	TRUE	FALSE
atoS	FALSE	TRUE	FALSE
atoC	FALSE	TRUE	FALSE
atoD	FALSE	TRUE	FALSE
atoA	FALSE	TRUE	FALSE
atoE	FALSE	TRUE	FALSE
atoB	FALSE	TRUE	FALSE
yfaP	FALSE	TRUE	FALSE
yfaQ	FALSE	TRUE	FALSE
yfaS	FALSE	TRUE	FALSE
yfaT	FALSE	TRUE	FALSE
yfaA	FALSE	TRUE	FALSE
gyrA	TRUE	FALSE	FALSE
ubiG	TRUE	FALSE	FALSE
yfaL	FALSE	TRUE	FALSE
nrdA	TRUE	FALSE	FALSE
nrdB	TRUE	FALSE	FALSE
yfaE	FALSE	TRUE	FALSE
inaA	FALSE	TRUE	FALSE
yfaH	FALSE	TRUE	FALSE
glpQ	FALSE	TRUE	FALSE
glpT	FALSE	TRUE	FALSE
glpA	FALSE	TRUE	FALSE
glpB	FALSE	TRUE	FALSE
glpC	FALSE	TRUE	FALSE
yfaD	FALSE	TRUE	FALSE
ypaA	FALSE	TRUE	FALSE
rhmA	FALSE	TRUE	FALSE
rhmT	FALSE	TRUE	FALSE
rhmD	FALSE	TRUE	FALSE
rhmR	FALSE	TRUE	FALSE
yfaY	FALSE	TRUE	FALSE
yfaZ	FALSE	TRUE	FALSE
nudI	FALSE	TRUE	FALSE
ais	FALSE	TRUE	FALSE
arnB	FALSE	TRUE	FALSE
arnC	FALSE	TRUE	FALSE
arnA	FALSE	TRUE	FALSE
arnD	FALSE	TRUE	FALSE
arnT	FALSE	TRUE	FALSE
arnE	FALSE	TRUE	FALSE
arnF	FALSE	TRUE	FALSE
pmrD	FALSE	TRUE	FALSE
menE	FALSE	TRUE	FALSE
menC	FALSE	TRUE	FALSE
menB	FALSE	TRUE	FALSE
menH	FALSE	TRUE	FALSE
menD	FALSE	TRUE	FALSE
menF	FALSE	TRUE	FALSE
elaB	FALSE	TRUE	FALSE
elaA	FALSE	TRUE	FALSE
rbn	FALSE	TRUE	FALSE
elaD	FALSE	FALSE	TRUE
yfbK	FALSE	TRUE	FALSE
yfbL	FALSE	TRUE	FALSE
yfbM	FALSE	TRUE	FALSE
yfbN	FALSE	TRUE	FALSE
yfbO	FALSE	TRUE	FALSE
yfbP	FALSE	TRUE	FALSE
nuoN	FALSE	TRUE	FALSE
nuoM	FALSE	TRUE	FALSE
nuoL	FALSE	TRUE	FALSE
nuoK	FALSE	FALSE	TRUE
nuoJ	FALSE	TRUE	FALSE
nuoI	FALSE	FALSE	TRUE
nuoH	FALSE	TRUE	FALSE
nuoG	FALSE	TRUE	FALSE
nuoF	FALSE	TRUE	FALSE
nuoE	FALSE	FALSE	TRUE
nuoC	FALSE	FALSE	TRUE
nuoB	FALSE	TRUE	FALSE
nuoA	FALSE	TRUE	FALSE
lrhA	FALSE	TRUE	FALSE
alaA	FALSE	TRUE	FALSE
yfbR	FALSE	TRUE	FALSE
yfbS	FALSE	TRUE	FALSE
yfbT	FALSE	TRUE	FALSE
yfbU	FALSE	TRUE	FALSE
yfbV	FALSE	TRUE	FALSE
ackA	FALSE	FALSE	TRUE
pta	FALSE	FALSE	TRUE
yfcC	FALSE	TRUE	FALSE
yfcD	FALSE	TRUE	FALSE
yfcE	FALSE	TRUE	FALSE
yfcF	FALSE	TRUE	FALSE
yfcG	FALSE	TRUE	FALSE
folX	FALSE	TRUE	FALSE
yfcH	FALSE	TRUE	FALSE
yfcI	FALSE	TRUE	FALSE
hisP	FALSE	TRUE	FALSE
hisM	FALSE	TRUE	FALSE
hisQ	FALSE	TRUE	FALSE
hisJ	FALSE	TRUE	FALSE
argT	FALSE	TRUE	FALSE
ubiX	TRUE	FALSE	FALSE
purF	FALSE	TRUE	FALSE
cvpA	FALSE	TRUE	FALSE
dedD	FALSE	TRUE	FALSE
folC	TRUE	FALSE	FALSE
accD	TRUE	FALSE	FALSE
dedA	FALSE	TRUE	FALSE
truA	FALSE	TRUE	FALSE
usg	FALSE	TRUE	FALSE
pdxB	FALSE	TRUE	FALSE
flk	FALSE	TRUE	FALSE
yfcJ	FALSE	TRUE	FALSE
fabB	TRUE	FALSE	FALSE
mnmC	FALSE	TRUE	FALSE
yfcL	FALSE	TRUE	FALSE
epmC	FALSE	TRUE	FALSE
yfcA	FALSE	TRUE	FALSE
mepA	FALSE	TRUE	FALSE
aroC	FALSE	TRUE	FALSE
prmB	FALSE	FALSE	TRUE
smrB	FALSE	TRUE	FALSE
yfcO	FALSE	TRUE	FALSE
yfcP	FALSE	TRUE	FALSE
yfcQ	FALSE	TRUE	FALSE
yfcR	FALSE	TRUE	FALSE
yfcS	FALSE	TRUE	FALSE
yfcU	FALSE	TRUE	FALSE
yfcV	FALSE	TRUE	FALSE
sixA	FALSE	TRUE	FALSE
fadJ	FALSE	TRUE	FALSE
fadI	FALSE	TRUE	FALSE
yfcZ	FALSE	TRUE	FALSE
fadL	FALSE	TRUE	FALSE
yfdF	FALSE	FALSE	TRUE
mlaA	FALSE	TRUE	FALSE
yfdC	FALSE	TRUE	FALSE
intS	FALSE	TRUE	FALSE
gtrA	FALSE	TRUE	FALSE
gtrB	FALSE	TRUE	FALSE
gtrS	FALSE	FALSE	TRUE
tfaS	FALSE	TRUE	FALSE
yfdK	FALSE	TRUE	FALSE
yfdL	FALSE	TRUE	FALSE
yfdM	FALSE	TRUE	FALSE
yfdN	FALSE	TRUE	FALSE
oweS	FALSE	TRUE	FALSE
yfdP	FALSE	TRUE	FALSE
yfdQ	FALSE	TRUE	FALSE
yfdR	FALSE	TRUE	FALSE
yfdS	FALSE	TRUE	FALSE
yfdT	FALSE	TRUE	FALSE
ypdJ	FALSE	TRUE	FALSE
torI	FALSE	TRUE	FALSE
dsdC	FALSE	TRUE	FALSE
dsdX	FALSE	TRUE	FALSE
dsdA	FALSE	TRUE	FALSE
emrY	FALSE	TRUE	FALSE
emrK	FALSE	TRUE	FALSE
evgA	FALSE	TRUE	FALSE
evgS	FALSE	TRUE	FALSE
yfdE	FALSE	TRUE	FALSE
yfdV	FALSE	TRUE	FALSE
oxc	FALSE	TRUE	FALSE
frc	FALSE	TRUE	FALSE
yfdX	FALSE	TRUE	FALSE
ypdI	FALSE	TRUE	FALSE
yfdY	FALSE	TRUE	FALSE
lpxP	FALSE	TRUE	FALSE
ypdK	FALSE	TRUE	FALSE
alaC	FALSE	TRUE	FALSE
ypdA	FALSE	TRUE	FALSE
ypdB	FALSE	TRUE	FALSE
ypdC	FALSE	TRUE	FALSE
fryA	FALSE	TRUE	FALSE
ypdE	FALSE	TRUE	FALSE
ypdF	FALSE	TRUE	FALSE
fryC	FALSE	TRUE	FALSE
fryB	FALSE	TRUE	FALSE
glk	FALSE	TRUE	FALSE
yfeO	FALSE	TRUE	FALSE
ypeC	FALSE	TRUE	FALSE
mntH	FALSE	TRUE	FALSE
nupC	FALSE	TRUE	FALSE
insL1	FALSE	TRUE	FALSE
yfeA	FALSE	TRUE	FALSE
yfeC	FALSE	TRUE	FALSE
yfeD	FALSE	TRUE	FALSE
gltX	TRUE	FALSE	FALSE
xapR	FALSE	TRUE	FALSE
xapB	FALSE	TRUE	FALSE
xapA	FALSE	TRUE	FALSE
yfeN	FALSE	TRUE	FALSE
yfeR	FALSE	TRUE	FALSE
yfeH	FALSE	TRUE	FALSE
ypeB	FALSE	TRUE	FALSE
ligA	TRUE	FALSE	FALSE
zipA	TRUE	FALSE	FALSE
cysZ	FALSE	TRUE	FALSE
cysK	FALSE	TRUE	FALSE
ptsH	TRUE	FALSE	FALSE
ptsI	TRUE	FALSE	FALSE
crr	TRUE	FALSE	FALSE
pdxK	FALSE	TRUE	FALSE
yfeK	FALSE	TRUE	FALSE
yfeS	FALSE	TRUE	FALSE
cysM	FALSE	TRUE	FALSE
cysA	FALSE	TRUE	FALSE
cysW	FALSE	TRUE	FALSE
cysU	FALSE	TRUE	FALSE
cysP	FALSE	TRUE	FALSE
ucpA	FALSE	TRUE	FALSE
murR	FALSE	TRUE	FALSE
murQ	FALSE	TRUE	FALSE
murP	FALSE	TRUE	FALSE
yfeW	FALSE	TRUE	FALSE
yfeX	FALSE	TRUE	FALSE
yfeY	FALSE	TRUE	FALSE
yfeZ	FALSE	TRUE	FALSE
ypeA	FALSE	TRUE	FALSE
amiA	FALSE	TRUE	FALSE
hemF	FALSE	TRUE	FALSE
eutR	FALSE	TRUE	FALSE
eutK	FALSE	TRUE	FALSE
eutL	FALSE	TRUE	FALSE
eutC	FALSE	TRUE	FALSE
eutB	FALSE	TRUE	FALSE
intZ	FALSE	TRUE	FALSE
yffL	FALSE	TRUE	FALSE
yffM	FALSE	TRUE	FALSE
yffN	FALSE	TRUE	FALSE
yffO	FALSE	TRUE	FALSE
yffP	FALSE	TRUE	FALSE
yffQ	FALSE	TRUE	FALSE
yffR	FALSE	TRUE	FALSE
yffS	FALSE	FALSE	TRUE
eutA	FALSE	TRUE	FALSE
eutH	FALSE	TRUE	FALSE
eutG	FALSE	TRUE	FALSE
eutJ	FALSE	TRUE	FALSE
eutE	FALSE	TRUE	FALSE
eutN	FALSE	TRUE	FALSE
eutM	FALSE	TRUE	FALSE
eutD	FALSE	TRUE	FALSE
eutT	FALSE	TRUE	FALSE
eutQ	FALSE	TRUE	FALSE
eutP	FALSE	TRUE	FALSE
eutS	FALSE	TRUE	FALSE
maeB	FALSE	TRUE	FALSE
talA	FALSE	TRUE	FALSE
tktB	FALSE	TRUE	FALSE
ypfG	FALSE	TRUE	FALSE
nudK	FALSE	TRUE	FALSE
aegA	FALSE	TRUE	FALSE
narQ	FALSE	TRUE	FALSE
acrD	FALSE	TRUE	FALSE
ypfM	FALSE	TRUE	FALSE
yffB	FALSE	TRUE	FALSE
dapE	TRUE	FALSE	FALSE
ypfN	FALSE	TRUE	FALSE
ypfH	FALSE	TRUE	FALSE
tmcA	FALSE	TRUE	FALSE
ypfJ	FALSE	TRUE	FALSE
purC	FALSE	TRUE	FALSE
bamC	FALSE	TRUE	FALSE
dapA	TRUE	FALSE	FALSE
gcvR	FALSE	TRUE	FALSE
bcp	FALSE	TRUE	FALSE
hyfA	FALSE	TRUE	FALSE
hyfB	FALSE	TRUE	FALSE
hyfC	FALSE	TRUE	FALSE
hyfD	FALSE	TRUE	FALSE
hyfE	FALSE	TRUE	FALSE
hyfF	FALSE	TRUE	FALSE
hyfG	FALSE	TRUE	FALSE
hyfH	FALSE	TRUE	FALSE
hyfI	FALSE	TRUE	FALSE
hyfJ	FALSE	TRUE	FALSE
hyfR	FALSE	TRUE	FALSE
focB	FALSE	TRUE	FALSE
yfgO	FALSE	TRUE	FALSE
bepA	FALSE	TRUE	FALSE
yfgD	FALSE	TRUE	FALSE
hda	TRUE	FALSE	FALSE
uraA	FALSE	TRUE	FALSE
upp	FALSE	TRUE	FALSE
purM	FALSE	TRUE	FALSE
purN	FALSE	TRUE	FALSE
ppk	FALSE	TRUE	FALSE
ppx	FALSE	TRUE	FALSE
yfgF	FALSE	TRUE	FALSE
yfgG	FALSE	TRUE	FALSE
yfgH	FALSE	TRUE	FALSE
yfgI	FALSE	TRUE	FALSE
guaA	TRUE	FALSE	FALSE
guaB	TRUE	FALSE	FALSE
xseA	FALSE	TRUE	FALSE
yfgJ	FALSE	TRUE	FALSE
der	TRUE	FALSE	FALSE
bamB	FALSE	TRUE	FALSE
yfgM	FALSE	TRUE	FALSE
hisS	TRUE	FALSE	FALSE
ispG	TRUE	FALSE	FALSE
rodZ	FALSE	TRUE	FALSE
rlmN	FALSE	TRUE	FALSE
ndk	FALSE	TRUE	FALSE
pbpC	FALSE	TRUE	FALSE
yfhM	FALSE	TRUE	FALSE
sseA	FALSE	TRUE	FALSE
sseB	FALSE	TRUE	FALSE
pepB	FALSE	TRUE	FALSE
iscX	FALSE	TRUE	FALSE
fdx	FALSE	FALSE	TRUE
hscA	TRUE	FALSE	FALSE
hscB	FALSE	FALSE	TRUE
iscA	FALSE	TRUE	FALSE
iscU	TRUE	FALSE	FALSE
iscS	TRUE	FALSE	FALSE
iscR	FALSE	FALSE	TRUE
trmJ	FALSE	TRUE	FALSE
suhB	TRUE	FALSE	FALSE
yfhR	FALSE	TRUE	FALSE
csiE	FALSE	TRUE	FALSE
hcaT	FALSE	TRUE	FALSE
hcaR	FALSE	TRUE	FALSE
iroK	FALSE	TRUE	FALSE
hcaE	FALSE	TRUE	FALSE
hcaF	FALSE	TRUE	FALSE
hcaC	FALSE	TRUE	FALSE
hcaB	FALSE	TRUE	FALSE
hcaD	FALSE	TRUE	FALSE
yphA	FALSE	TRUE	FALSE
yphB	FALSE	TRUE	FALSE
yphC	FALSE	TRUE	FALSE
yphD	FALSE	TRUE	FALSE
yphE	FALSE	TRUE	FALSE
yphF	FALSE	TRUE	FALSE
yphG	FALSE	TRUE	FALSE
yphH	FALSE	TRUE	FALSE
glyA	TRUE	FALSE	FALSE
hmp	FALSE	TRUE	FALSE
glnB	FALSE	TRUE	FALSE
glrR	FALSE	TRUE	FALSE
yfhG	FALSE	TRUE	FALSE
glrK	FALSE	TRUE	FALSE
purL	FALSE	TRUE	FALSE
mltF	FALSE	TRUE	FALSE
tadA	TRUE	FALSE	FALSE
pgpC	FALSE	TRUE	FALSE
yfhH	FALSE	TRUE	FALSE
yfhL	FALSE	TRUE	FALSE
shoB	FALSE	TRUE	FALSE
acpS	TRUE	FALSE	FALSE
pdxJ	FALSE	TRUE	FALSE
recO	FALSE	TRUE	FALSE
era	TRUE	FALSE	FALSE
rnc	FALSE	FALSE	TRUE
lepB	TRUE	FALSE	FALSE
lepA	FALSE	FALSE	TRUE
rseC	FALSE	TRUE	FALSE
rseB	FALSE	TRUE	FALSE
rseA	FALSE	TRUE	FALSE
rpoE	TRUE	FALSE	FALSE
nadB	FALSE	TRUE	FALSE
trmN	FALSE	TRUE	FALSE
srmB	FALSE	TRUE	FALSE
yfiE	FALSE	TRUE	FALSE
eamB	FALSE	TRUE	FALSE
grcA	FALSE	TRUE	FALSE
ung	FALSE	TRUE	FALSE
yfiF	FALSE	TRUE	FALSE
trxC	FALSE	TRUE	FALSE
yfiP	FALSE	TRUE	FALSE
pka	FALSE	TRUE	FALSE
pssA	TRUE	FALSE	FALSE
yfiM	FALSE	TRUE	FALSE
kgtP	FALSE	TRUE	FALSE
clpB	FALSE	TRUE	FALSE
yfiH	FALSE	TRUE	FALSE
rluD	TRUE	FALSE	FALSE
bamD	TRUE	FALSE	FALSE
raiA	FALSE	TRUE	FALSE
pheL	FALSE	TRUE	FALSE
pheA	FALSE	TRUE	FALSE
tyrA	FALSE	TRUE	FALSE
aroF	FALSE	TRUE	FALSE
yfiL	FALSE	TRUE	FALSE
yfiR	FALSE	TRUE	FALSE
yfiN	FALSE	TRUE	FALSE
yfiB	FALSE	TRUE	FALSE
rplS	TRUE	FALSE	FALSE
trmD	TRUE	FALSE	FALSE
rimM	TRUE	FALSE	FALSE
rpsP	TRUE	FALSE	FALSE
ffh	TRUE	FALSE	FALSE
ypjD	FALSE	TRUE	FALSE
yfjD	FALSE	TRUE	FALSE
grpE	FALSE	FALSE	TRUE
nadK	TRUE	FALSE	FALSE
recN	FALSE	TRUE	FALSE
bamE	FALSE	TRUE	FALSE
ratB	FALSE	TRUE	FALSE
ratA	FALSE	FALSE	TRUE
smpB	FALSE	TRUE	FALSE
intA	FALSE	TRUE	FALSE
yfjH	FALSE	TRUE	FALSE
alpA	FALSE	TRUE	FALSE
yfjI	FALSE	TRUE	FALSE
yfjJ	FALSE	TRUE	FALSE
yfjK	FALSE	TRUE	FALSE
yfjL	FALSE	TRUE	FALSE
yfjM	FALSE	TRUE	FALSE
rnlA	FALSE	TRUE	FALSE
rnlB	FALSE	TRUE	FALSE
yfjP	FALSE	TRUE	FALSE
yfjQ	FALSE	TRUE	FALSE
yfjR	FALSE	TRUE	FALSE
ypjK	FALSE	TRUE	FALSE
yfjS	FALSE	TRUE	FALSE
yfjT	FALSE	TRUE	FALSE
yfjU	FALSE	TRUE	FALSE
yfjV	FALSE	TRUE	FALSE
yfjW	FALSE	FALSE	TRUE
ypjI	FALSE	TRUE	FALSE
yfjX	FALSE	TRUE	FALSE
yfjY	FALSE	TRUE	FALSE
ypjJ	FALSE	TRUE	FALSE
yfjZ	FALSE	TRUE	FALSE
ypjF	FALSE	TRUE	FALSE
ypjA	FALSE	TRUE	FALSE
pinH	FALSE	TRUE	FALSE
ypjC	FALSE	FALSE	TRUE
ygaQ	FALSE	TRUE	FALSE
csiD	FALSE	TRUE	FALSE
lhgO	FALSE	TRUE	FALSE
gabD	FALSE	TRUE	FALSE
gabT	FALSE	TRUE	FALSE
gabP	FALSE	TRUE	FALSE
csiR	FALSE	TRUE	FALSE
ygaU	FALSE	TRUE	FALSE
yqaE	FALSE	TRUE	FALSE
ygaV	FALSE	TRUE	FALSE
ygaP	FALSE	TRUE	FALSE
stpA	FALSE	TRUE	FALSE
alaE	FALSE	TRUE	FALSE
ygaC	FALSE	TRUE	FALSE
ygaM	FALSE	TRUE	FALSE
nrdH	FALSE	TRUE	FALSE
nrdI	FALSE	TRUE	FALSE
nrdE	FALSE	TRUE	FALSE
nrdF	FALSE	TRUE	FALSE
proV	FALSE	TRUE	FALSE
proW	FALSE	TRUE	FALSE
proX	FALSE	TRUE	FALSE
ygaY	FALSE	TRUE	FALSE
ygaZ	FALSE	TRUE	FALSE
ygaH	FALSE	TRUE	FALSE
mprA	FALSE	TRUE	FALSE
emrA	FALSE	TRUE	FALSE
emrB	FALSE	TRUE	FALSE
luxS	FALSE	TRUE	FALSE
gshA	FALSE	TRUE	FALSE
yqaA	FALSE	TRUE	FALSE
yqaB	FALSE	TRUE	FALSE
csrA	TRUE	FALSE	FALSE
alaS	TRUE	FALSE	FALSE
recX	FALSE	TRUE	FALSE
recA	FALSE	FALSE	TRUE
pncC	FALSE	TRUE	FALSE
mltB	FALSE	TRUE	FALSE
srlA	FALSE	TRUE	FALSE
srlE	FALSE	TRUE	FALSE
srlB	FALSE	TRUE	FALSE
srlD	FALSE	TRUE	FALSE
srlM	FALSE	TRUE	FALSE
srlR	FALSE	TRUE	FALSE
srlQ	FALSE	TRUE	FALSE
norR	FALSE	TRUE	FALSE
norV	FALSE	TRUE	FALSE
norW	FALSE	TRUE	FALSE
hypF	FALSE	TRUE	FALSE
hydN	FALSE	TRUE	FALSE
ascG	FALSE	TRUE	FALSE
ascF	FALSE	TRUE	FALSE
ascB	FALSE	TRUE	FALSE
hycI	FALSE	TRUE	FALSE
hycH	FALSE	TRUE	FALSE
hycG	FALSE	TRUE	FALSE
hycF	FALSE	TRUE	FALSE
hycE	FALSE	TRUE	FALSE
hycD	FALSE	TRUE	FALSE
hycC	FALSE	TRUE	FALSE
hycB	FALSE	TRUE	FALSE
hycA	FALSE	TRUE	FALSE
hypA	FALSE	TRUE	FALSE
hypB	FALSE	TRUE	FALSE
hypC	FALSE	TRUE	FALSE
hypD	FALSE	TRUE	FALSE
hypE	FALSE	TRUE	FALSE
fhlA	FALSE	TRUE	FALSE
ygbA	FALSE	TRUE	FALSE
mutS	FALSE	TRUE	FALSE
pphB	FALSE	TRUE	FALSE
ygbI	FALSE	TRUE	FALSE
ygbJ	FALSE	TRUE	FALSE
ygbK	FALSE	TRUE	FALSE
ygbL	FALSE	TRUE	FALSE
ygbM	FALSE	TRUE	FALSE
ygbN	FALSE	TRUE	FALSE
rpoS	FALSE	TRUE	FALSE
nlpD	FALSE	TRUE	FALSE
pcm	FALSE	TRUE	FALSE
umpG	FALSE	TRUE	FALSE
truD	FALSE	TRUE	FALSE
ispF	TRUE	FALSE	FALSE
ispD	TRUE	FALSE	FALSE
ftsB	FALSE	FALSE	TRUE
ygbE	FALSE	TRUE	FALSE
cysC	FALSE	TRUE	FALSE
cysN	FALSE	TRUE	FALSE
cysD	FALSE	TRUE	FALSE
iap	FALSE	TRUE	FALSE
ygbF	FALSE	TRUE	FALSE
ygbT	FALSE	TRUE	FALSE
casE	FALSE	TRUE	FALSE
casD	FALSE	TRUE	FALSE
casC	FALSE	TRUE	FALSE
casB	FALSE	TRUE	FALSE
casA	FALSE	TRUE	FALSE
ygcB	FALSE	TRUE	FALSE
cysH	FALSE	TRUE	FALSE
cysI	FALSE	TRUE	FALSE
cysJ	FALSE	TRUE	FALSE
queD	FALSE	TRUE	FALSE
ygcN	FALSE	TRUE	FALSE
ygcO	FALSE	TRUE	FALSE
ygcP	FALSE	TRUE	FALSE
ygcQ	FALSE	TRUE	FALSE
ygcR	FALSE	TRUE	FALSE
ygcS	FALSE	TRUE	FALSE
ygcU	FALSE	TRUE	FALSE
ygcW	FALSE	TRUE	FALSE
yqcE	FALSE	TRUE	FALSE
ygcE	FALSE	TRUE	FALSE
queE	FALSE	TRUE	FALSE
yqcG	FALSE	FALSE	TRUE
ygcG	FALSE	TRUE	FALSE
eno	TRUE	FALSE	FALSE
pyrG	TRUE	FALSE	FALSE
mazG	FALSE	TRUE	FALSE
mazF	FALSE	TRUE	FALSE
mazE	FALSE	TRUE	FALSE
relA	FALSE	TRUE	FALSE
rlmD	FALSE	TRUE	FALSE
barA	FALSE	TRUE	FALSE
gudD	FALSE	TRUE	FALSE
gudX	FALSE	TRUE	FALSE
gudP	FALSE	TRUE	FALSE
yqcA	FALSE	TRUE	FALSE
truC	FALSE	TRUE	FALSE
yqcC	FALSE	TRUE	FALSE
syd	FALSE	TRUE	FALSE
queF	FALSE	TRUE	FALSE
ygdH	FALSE	TRUE	FALSE
sdaC	FALSE	TRUE	FALSE
sdaB	FALSE	TRUE	FALSE
ygdG	FALSE	TRUE	FALSE
fucO	FALSE	TRUE	FALSE
fucA	FALSE	TRUE	FALSE
fucP	FALSE	TRUE	FALSE
fucI	FALSE	TRUE	FALSE
fucK	FALSE	TRUE	FALSE
fucU	FALSE	TRUE	FALSE
fucR	FALSE	TRUE	FALSE
rlmM	FALSE	TRUE	FALSE
ygdD	FALSE	TRUE	FALSE
gcvA	FALSE	TRUE	FALSE
ygdI	FALSE	TRUE	FALSE
csdA	FALSE	TRUE	FALSE
csdE	FALSE	TRUE	FALSE
tcdA	FALSE	TRUE	FALSE
mltA	FALSE	TRUE	FALSE
amiC	FALSE	TRUE	FALSE
argA	FALSE	TRUE	FALSE
recD	FALSE	TRUE	FALSE
recB	FALSE	FALSE	TRUE
ptrA	FALSE	TRUE	FALSE
recC	FALSE	TRUE	FALSE
ppdC	FALSE	TRUE	FALSE
ygdB	FALSE	TRUE	FALSE
ppdB	FALSE	TRUE	FALSE
ppdA	FALSE	TRUE	FALSE
thyA	TRUE	FALSE	FALSE
lgt	TRUE	FALSE	FALSE
ptsP	FALSE	TRUE	FALSE
rppH	FALSE	TRUE	FALSE
mutH	FALSE	TRUE	FALSE
ygdQ	FALSE	TRUE	FALSE
ygdR	FALSE	TRUE	FALSE
tas	FALSE	TRUE	FALSE
lplT	FALSE	TRUE	FALSE
aas	FALSE	TRUE	FALSE
galR	FALSE	TRUE	FALSE
lysA	FALSE	TRUE	FALSE
lysR	FALSE	TRUE	FALSE
ygeA	FALSE	TRUE	FALSE
araE	FALSE	TRUE	FALSE
kduD	FALSE	TRUE	FALSE
kduI	FALSE	TRUE	FALSE
yqeF	FALSE	TRUE	FALSE
yqeG	FALSE	TRUE	FALSE
yqeH	FALSE	TRUE	FALSE
yqeI	FALSE	TRUE	FALSE
yqeJ	FALSE	FALSE	TRUE
yqeL	FALSE	TRUE	FALSE
yqeK	FALSE	FALSE	TRUE
ygeF	TRUE	FALSE	FALSE
ygeG	FALSE	FALSE	TRUE
ygeH	FALSE	TRUE	FALSE
ygeI	FALSE	TRUE	FALSE
pbl	FALSE	FALSE	TRUE
ygeK	FALSE	TRUE	FALSE
ygeN	TRUE	FALSE	FALSE
ygeO	FALSE	TRUE	FALSE
insD1	FALSE	TRUE	FALSE
insC1	FALSE	TRUE	FALSE
ygeQ	FALSE	TRUE	FALSE
ygeR	FALSE	TRUE	FALSE
xdhA	FALSE	TRUE	FALSE
xdhB	FALSE	TRUE	FALSE
xdhC	FALSE	TRUE	FALSE
ygeV	FALSE	TRUE	FALSE
ygeW	FALSE	TRUE	FALSE
ygeX	FALSE	TRUE	FALSE
ygeY	FALSE	TRUE	FALSE
hyuA	FALSE	TRUE	FALSE
yqeA	FALSE	TRUE	FALSE
yqeB	FALSE	TRUE	FALSE
yqeC	FALSE	TRUE	FALSE
mocA	FALSE	TRUE	FALSE
ygfK	FALSE	TRUE	FALSE
ssnA	FALSE	TRUE	FALSE
ygfM	FALSE	TRUE	FALSE
xdhD	FALSE	TRUE	FALSE
xanQ	FALSE	TRUE	FALSE
guaD	FALSE	TRUE	FALSE
ygfQ	FALSE	TRUE	FALSE
ygfS	FALSE	TRUE	FALSE
ygfT	FALSE	TRUE	FALSE
uacT	FALSE	TRUE	FALSE
yqfG	FALSE	TRUE	FALSE
idi	FALSE	TRUE	FALSE
lysS	TRUE	FALSE	FALSE
prfB	TRUE	FALSE	FALSE
recJ	FALSE	TRUE	FALSE
dsbC	FALSE	TRUE	FALSE
xerD	FALSE	TRUE	FALSE
fldB	FALSE	TRUE	FALSE
cptA	FALSE	TRUE	FALSE
sdhE	FALSE	TRUE	FALSE
ygfZ	FALSE	FALSE	TRUE
yqfA	FALSE	TRUE	FALSE
yqfB	FALSE	TRUE	FALSE
bglA	FALSE	TRUE	FALSE
ygfF	FALSE	TRUE	FALSE
gcvP	FALSE	TRUE	FALSE
gcvH	FALSE	TRUE	FALSE
gcvT	FALSE	TRUE	FALSE
ubiI	FALSE	TRUE	FALSE
ubiH	TRUE	FALSE	FALSE
pepP	FALSE	TRUE	FALSE
ygfB	FALSE	TRUE	FALSE
zapA	FALSE	TRUE	FALSE
fau	FALSE	TRUE	FALSE
ibsC	FALSE	TRUE	FALSE
serA	FALSE	TRUE	FALSE
rpiA	FALSE	FALSE	TRUE
yqfE	FALSE	TRUE	FALSE
argP	FALSE	TRUE	FALSE
scpA	FALSE	TRUE	FALSE
argK	FALSE	TRUE	FALSE
scpB	FALSE	TRUE	FALSE
scpC	FALSE	TRUE	FALSE
ygfI	FALSE	TRUE	FALSE
yggE	FALSE	TRUE	FALSE
argO	FALSE	TRUE	FALSE
mscS	FALSE	TRUE	FALSE
fbaA	TRUE	FALSE	FALSE
pgk	TRUE	FALSE	FALSE
epd	FALSE	TRUE	FALSE
yggC	FALSE	TRUE	FALSE
yggD	FALSE	TRUE	FALSE
yggF	FALSE	TRUE	FALSE
yggP	FALSE	TRUE	FALSE
cmtA	FALSE	TRUE	FALSE
cmtB	FALSE	TRUE	FALSE
tktA	FALSE	FALSE	TRUE
loiP	FALSE	TRUE	FALSE
speB	FALSE	TRUE	FALSE
speA	FALSE	TRUE	FALSE
yqgB	FALSE	TRUE	FALSE
yqgC	FALSE	TRUE	FALSE
metK	TRUE	FALSE	FALSE
galP	FALSE	TRUE	FALSE
yggI	FALSE	TRUE	FALSE
endA	FALSE	TRUE	FALSE
rsmE	FALSE	TRUE	FALSE
gshB	FALSE	TRUE	FALSE
yqgE	FALSE	TRUE	FALSE
yqgF	TRUE	FALSE	FALSE
yggR	FALSE	TRUE	FALSE
yggS	FALSE	TRUE	FALSE
yggT	FALSE	TRUE	FALSE
yggU	FALSE	TRUE	FALSE
rdgB	FALSE	TRUE	FALSE
yggW	FALSE	TRUE	FALSE
yggM	FALSE	TRUE	FALSE
ansB	FALSE	TRUE	FALSE
yggN	FALSE	TRUE	FALSE
yggL	FALSE	TRUE	FALSE
trmI	FALSE	TRUE	FALSE
mutY	FALSE	TRUE	FALSE
yggX	FALSE	TRUE	FALSE
mltC	FALSE	TRUE	FALSE
nupG	FALSE	TRUE	FALSE
speC	FALSE	TRUE	FALSE
yqgA	FALSE	TRUE	FALSE
yghD	FALSE	TRUE	FALSE
yghE	FALSE	TRUE	FALSE
yghF	FALSE	TRUE	FALSE
yghG	FALSE	TRUE	FALSE
pppA	FALSE	TRUE	FALSE
yghJ	FALSE	TRUE	FALSE
glcA	FALSE	TRUE	FALSE
glcB	FALSE	TRUE	FALSE
glcG	FALSE	TRUE	FALSE
glcF	FALSE	TRUE	FALSE
glcE	FALSE	TRUE	FALSE
glcD	FALSE	TRUE	FALSE
glcC	FALSE	TRUE	FALSE
yghO	FALSE	TRUE	FALSE
insH1	FALSE	TRUE	FALSE
yghQ	FALSE	TRUE	FALSE
yghR	FALSE	TRUE	FALSE
yghS	FALSE	TRUE	FALSE
yghT	FALSE	TRUE	FALSE
pitB	FALSE	TRUE	FALSE
gss	FALSE	TRUE	FALSE
yghU	FALSE	TRUE	FALSE
hybG	FALSE	TRUE	FALSE
hybF	FALSE	TRUE	FALSE
hybE	FALSE	TRUE	FALSE
hybD	FALSE	TRUE	FALSE
hybC	FALSE	TRUE	FALSE
hybB	FALSE	TRUE	FALSE
hybA	FALSE	TRUE	FALSE
hybO	FALSE	TRUE	FALSE
yghW	FALSE	TRUE	FALSE
yghX	FALSE	TRUE	FALSE
gpr	FALSE	TRUE	FALSE
yqhA	FALSE	TRUE	FALSE
yghA	FALSE	TRUE	FALSE
exbD	FALSE	TRUE	FALSE
exbB	FALSE	TRUE	FALSE
metC	FALSE	TRUE	FALSE
yghB	FALSE	TRUE	FALSE
yqhC	FALSE	TRUE	FALSE
yqhD	FALSE	TRUE	FALSE
dkgA	FALSE	TRUE	FALSE
yqhG	FALSE	TRUE	FALSE
yqhH	FALSE	TRUE	FALSE
ygiQ	FALSE	TRUE	FALSE
ftsP	FALSE	TRUE	FALSE
plsC	TRUE	FALSE	FALSE
parC	TRUE	FALSE	FALSE
ygiS	FALSE	TRUE	FALSE
mqsA	FALSE	TRUE	FALSE
mqsR	FALSE	TRUE	FALSE
ygiV	FALSE	TRUE	FALSE
ygiW	FALSE	TRUE	FALSE
qseB	FALSE	TRUE	FALSE
qseC	FALSE	TRUE	FALSE
ygiZ	FALSE	TRUE	FALSE
mdaB	FALSE	TRUE	FALSE
ygiN	FALSE	TRUE	FALSE
parE	TRUE	FALSE	FALSE
yqiA	FALSE	TRUE	FALSE
cpdA	FALSE	TRUE	FALSE
yqiB	FALSE	TRUE	FALSE
nudF	FALSE	TRUE	FALSE
tolC	FALSE	TRUE	FALSE
ygiB	FALSE	TRUE	FALSE
ygiC	FALSE	TRUE	FALSE
ygiD	FALSE	TRUE	FALSE
zupT	FALSE	TRUE	FALSE
ribB	FALSE	TRUE	FALSE
yqiC	FALSE	TRUE	FALSE
ygiL	FALSE	TRUE	FALSE
yqiG	FALSE	TRUE	FALSE
insC1	FALSE	TRUE	FALSE
insD1	FALSE	TRUE	FALSE
yqiH	FALSE	TRUE	FALSE
yqiI	FALSE	TRUE	FALSE
glgS	FALSE	TRUE	FALSE
yqiJ	FALSE	TRUE	FALSE
yqiK	FALSE	TRUE	FALSE
ibsD	FALSE	TRUE	FALSE
ibsE	FALSE	TRUE	FALSE
hldE	FALSE	FALSE	TRUE
glnE	FALSE	TRUE	FALSE
ygiF	FALSE	TRUE	FALSE
ygiM	FALSE	TRUE	FALSE
cca	TRUE	FALSE	FALSE
bacA	FALSE	TRUE	FALSE
folB	TRUE	FALSE	FALSE
plsY	FALSE	TRUE	FALSE
ttdR	FALSE	TRUE	FALSE
ttdA	FALSE	TRUE	FALSE
ttdB	FALSE	TRUE	FALSE
ttdT	FALSE	TRUE	FALSE
tsaD	TRUE	FALSE	FALSE
rpsU	TRUE	FALSE	FALSE
dnaG	TRUE	FALSE	FALSE
rpoD	TRUE	FALSE	FALSE
mug	FALSE	TRUE	FALSE
yqjH	FALSE	TRUE	FALSE
yqjI	FALSE	TRUE	FALSE
aer	FALSE	TRUE	FALSE
patA	FALSE	TRUE	FALSE
ygjH	FALSE	TRUE	FALSE
ebgR	FALSE	TRUE	FALSE
ebgA	FALSE	TRUE	FALSE
ebgC	FALSE	TRUE	FALSE
ygjI	FALSE	TRUE	FALSE
ygjJ	FALSE	TRUE	FALSE
ygjK	FALSE	TRUE	FALSE
fadH	FALSE	TRUE	FALSE
higA	TRUE	FALSE	FALSE
higB	FALSE	TRUE	FALSE
rlmG	FALSE	TRUE	FALSE
ygjP	FALSE	TRUE	FALSE
ygjQ	FALSE	TRUE	FALSE
ygjR	FALSE	TRUE	FALSE
alx	FALSE	TRUE	FALSE
sstT	FALSE	TRUE	FALSE
ygjV	FALSE	TRUE	FALSE
uxaA	FALSE	TRUE	FALSE
uxaC	FALSE	TRUE	FALSE
exuT	FALSE	TRUE	FALSE
exuR	FALSE	TRUE	FALSE
yqjA	FALSE	TRUE	FALSE
mzrA	FALSE	TRUE	FALSE
yqjC	FALSE	TRUE	FALSE
yqjD	FALSE	TRUE	FALSE
yqjE	FALSE	TRUE	FALSE
yqjK	FALSE	TRUE	FALSE
yqjF	FALSE	TRUE	FALSE
yqjG	FALSE	TRUE	FALSE
yhaH	FALSE	TRUE	FALSE
yhaI	FALSE	TRUE	FALSE
yhaJ	FALSE	TRUE	FALSE
yhaK	FALSE	TRUE	FALSE
yhaL	FALSE	TRUE	FALSE
yhaM	FALSE	TRUE	FALSE
yhaO	FALSE	TRUE	FALSE
tdcG	FALSE	TRUE	FALSE
tdcF	FALSE	TRUE	FALSE
tdcE	FALSE	TRUE	FALSE
tdcD	FALSE	TRUE	FALSE
tdcC	FALSE	TRUE	FALSE
tdcB	FALSE	TRUE	FALSE
tdcA	FALSE	TRUE	FALSE
tdcR	FALSE	TRUE	FALSE
yhaB	FALSE	TRUE	FALSE
yhaC	FALSE	TRUE	FALSE
garK	FALSE	TRUE	FALSE
garR	FALSE	TRUE	FALSE
garL	FALSE	TRUE	FALSE
garP	FALSE	TRUE	FALSE
garD	FALSE	TRUE	FALSE
prlF	FALSE	TRUE	FALSE
yhaV	FALSE	TRUE	FALSE
agaR	FALSE	TRUE	FALSE
kbaZ	FALSE	TRUE	FALSE
agaV	FALSE	TRUE	FALSE
agaW	FALSE	TRUE	FALSE
agaA	FALSE	TRUE	FALSE
agaS	FALSE	TRUE	FALSE
kbaY	FALSE	TRUE	FALSE
agaB	FALSE	TRUE	FALSE
agaC	FALSE	TRUE	FALSE
agaD	FALSE	TRUE	FALSE
agaI	FALSE	TRUE	FALSE
yraH	FALSE	TRUE	FALSE
yraI	FALSE	TRUE	FALSE
yraJ	FALSE	TRUE	FALSE
yraK	FALSE	TRUE	FALSE
rsmI	FALSE	TRUE	FALSE
lpoA	FALSE	TRUE	FALSE
yraN	FALSE	TRUE	FALSE
diaA	FALSE	TRUE	FALSE
yraP	FALSE	TRUE	FALSE
yraQ	FALSE	TRUE	FALSE
yraR	FALSE	TRUE	FALSE
yhbO	FALSE	TRUE	FALSE
yhbP	FALSE	TRUE	FALSE
yhbQ	FALSE	TRUE	FALSE
yhbS	FALSE	TRUE	FALSE
yhbT	FALSE	TRUE	FALSE
yhbU	FALSE	TRUE	FALSE
yhbV	FALSE	TRUE	FALSE
yhbW	FALSE	TRUE	FALSE
mtr	FALSE	TRUE	FALSE
deaD	FALSE	TRUE	FALSE
yrbN	FALSE	TRUE	FALSE
nlpI	FALSE	TRUE	FALSE
pnp	FALSE	FALSE	TRUE
rpsO	TRUE	FALSE	FALSE
truB	FALSE	TRUE	FALSE
rbfA	FALSE	FALSE	TRUE
infB	TRUE	FALSE	FALSE
nusA	TRUE	FALSE	FALSE
rimP	FALSE	TRUE	FALSE
argG	FALSE	TRUE	FALSE
yhbX	FALSE	TRUE	FALSE
secG	FALSE	TRUE	FALSE
glmM	TRUE	FALSE	FALSE
folP	TRUE	FALSE	FALSE
ftsH	TRUE	FALSE	FALSE
rlmE	TRUE	FALSE	FALSE
yhbY	FALSE	TRUE	FALSE
greA	FALSE	TRUE	FALSE
dacB	FALSE	TRUE	FALSE
obgE	TRUE	FALSE	FALSE
yhbE	FALSE	TRUE	FALSE
rpmA	TRUE	FALSE	FALSE
rplU	TRUE	FALSE	FALSE
ispB	TRUE	FALSE	FALSE
sfsB	FALSE	TRUE	FALSE
murA	TRUE	FALSE	FALSE
ibaG	FALSE	TRUE	FALSE
mlaB	FALSE	TRUE	FALSE
mlaC	FALSE	TRUE	FALSE
mlaD	FALSE	TRUE	FALSE
mlaE	FALSE	TRUE	FALSE
mlaF	FALSE	TRUE	FALSE
yrbG	FALSE	TRUE	FALSE
kdsD	FALSE	TRUE	FALSE
kdsC	FALSE	TRUE	FALSE
lptC	FALSE	TRUE	FALSE
lptA	FALSE	FALSE	TRUE
lptB	TRUE	FALSE	FALSE
rpoN	FALSE	TRUE	FALSE
hpf	FALSE	TRUE	FALSE
ptsN	FALSE	TRUE	FALSE
yhbJ	FALSE	TRUE	FALSE
npr	FALSE	TRUE	FALSE
yrbL	FALSE	TRUE	FALSE
mtgA	FALSE	TRUE	FALSE
elbB	FALSE	TRUE	FALSE
arcB	FALSE	TRUE	FALSE
yhcC	FALSE	TRUE	FALSE
gltB	FALSE	TRUE	FALSE
gltD	FALSE	TRUE	FALSE
gltF	FALSE	TRUE	FALSE
yhcA	FALSE	TRUE	FALSE
yhcD	FALSE	TRUE	FALSE
yhcE	FALSE	TRUE	FALSE
insH1	FALSE	TRUE	FALSE
yhcF	FALSE	TRUE	FALSE
yhcG	FALSE	TRUE	FALSE
yhcH	FALSE	TRUE	FALSE
nanK	FALSE	TRUE	FALSE
nanE	FALSE	TRUE	FALSE
nanT	FALSE	TRUE	FALSE
nanA	FALSE	TRUE	FALSE
nanR	FALSE	TRUE	FALSE
dcuD	FALSE	TRUE	FALSE
sspB	FALSE	TRUE	FALSE
sspA	FALSE	TRUE	FALSE
rpsI	TRUE	FALSE	FALSE
rplM	TRUE	FALSE	FALSE
yhcM	FALSE	TRUE	FALSE
yhcB	FALSE	TRUE	FALSE
degQ	FALSE	TRUE	FALSE
degS	TRUE	FALSE	FALSE
mdh	FALSE	TRUE	FALSE
argR	FALSE	TRUE	FALSE
yhcN	FALSE	TRUE	FALSE
yhcO	FALSE	TRUE	FALSE
aaeB	FALSE	TRUE	FALSE
aaeA	FALSE	TRUE	FALSE
aaeX	FALSE	TRUE	FALSE
aaeR	FALSE	TRUE	FALSE
tldD	FALSE	TRUE	FALSE
yhdP	FALSE	TRUE	FALSE
rng	FALSE	TRUE	FALSE
yhdE	FALSE	TRUE	FALSE
mreD	FALSE	FALSE	TRUE
mreC	FALSE	FALSE	TRUE
mreB	TRUE	FALSE	FALSE
csrD	FALSE	TRUE	FALSE
acuI	FALSE	TRUE	FALSE
yrdF	FALSE	TRUE	FALSE
yrdE	FALSE	TRUE	FALSE
accB	TRUE	FALSE	FALSE
accC	TRUE	FALSE	FALSE
yhdT	FALSE	TRUE	FALSE
panF	FALSE	TRUE	FALSE
prmA	FALSE	TRUE	FALSE
dusB	FALSE	TRUE	FALSE
fis	FALSE	TRUE	FALSE
yhdJ	FALSE	TRUE	FALSE
yhdU	FALSE	TRUE	FALSE
acrS	FALSE	TRUE	FALSE
acrE	FALSE	TRUE	FALSE
acrF	FALSE	TRUE	FALSE
yhdV	FALSE	TRUE	FALSE
yhdW	FALSE	TRUE	FALSE
yhdX	FALSE	TRUE	FALSE
yhdY	FALSE	TRUE	FALSE
yhdZ	FALSE	TRUE	FALSE
yrdA	FALSE	TRUE	FALSE
yrdB	FALSE	TRUE	FALSE
aroE	FALSE	TRUE	FALSE
tsaC	TRUE	FALSE	FALSE
yrdD	FALSE	TRUE	FALSE
smg	FALSE	TRUE	FALSE
smf	FALSE	TRUE	FALSE
def	TRUE	FALSE	FALSE
fmt	TRUE	FALSE	FALSE
rsmB	FALSE	TRUE	FALSE
trkA	FALSE	TRUE	FALSE
mscL	FALSE	TRUE	FALSE
arfA	FALSE	TRUE	FALSE
zntR	FALSE	TRUE	FALSE
yhdN	FALSE	TRUE	FALSE
rplQ	TRUE	FALSE	FALSE
rpoA	TRUE	FALSE	FALSE
rpsD	TRUE	FALSE	FALSE
rpsK	TRUE	FALSE	FALSE
rpsM	TRUE	FALSE	FALSE
rpmJ	TRUE	FALSE	FALSE
secY	TRUE	FALSE	FALSE
rplO	TRUE	FALSE	FALSE
rpmD	TRUE	FALSE	FALSE
rpsE	TRUE	FALSE	FALSE
rplR	TRUE	FALSE	FALSE
rplF	TRUE	FALSE	FALSE
rpsH	TRUE	FALSE	FALSE
rpsN	TRUE	FALSE	FALSE
rplE	TRUE	FALSE	FALSE
rplX	TRUE	FALSE	FALSE
rplN	TRUE	FALSE	FALSE
rpsQ	TRUE	FALSE	FALSE
rpmC	TRUE	FALSE	FALSE
rplP	TRUE	FALSE	FALSE
rpsC	TRUE	FALSE	FALSE
rplV	TRUE	FALSE	FALSE
rpsS	TRUE	FALSE	FALSE
rplB	TRUE	FALSE	FALSE
rplW	TRUE	FALSE	FALSE
rplD	TRUE	FALSE	FALSE
rplC	TRUE	FALSE	FALSE
rpsJ	TRUE	FALSE	FALSE
gspB	FALSE	TRUE	FALSE
gspA	FALSE	TRUE	FALSE
gspC	FALSE	TRUE	FALSE
gspD	FALSE	TRUE	FALSE
gspE	FALSE	TRUE	FALSE
gspF	FALSE	TRUE	FALSE
gspG	FALSE	TRUE	FALSE
gspH	FALSE	TRUE	FALSE
gspI	FALSE	TRUE	FALSE
gspJ	FALSE	TRUE	FALSE
gspK	FALSE	TRUE	FALSE
gspL	FALSE	TRUE	FALSE
gspM	FALSE	TRUE	FALSE
gspO	FALSE	TRUE	FALSE
bfr	FALSE	TRUE	FALSE
bfd	FALSE	TRUE	FALSE
chiA	FALSE	TRUE	FALSE
tufA	FALSE	TRUE	FALSE
fusA	TRUE	FALSE	FALSE
rpsG	TRUE	FALSE	FALSE
rpsL	TRUE	FALSE	FALSE
tusB	FALSE	FALSE	TRUE
tusC	TRUE	FALSE	FALSE
tusD	FALSE	FALSE	TRUE
yheO	FALSE	TRUE	FALSE
fkpA	FALSE	TRUE	FALSE
slyX	FALSE	TRUE	FALSE
slyD	FALSE	TRUE	FALSE
yheV	FALSE	TRUE	FALSE
kefB	FALSE	TRUE	FALSE
kefG	FALSE	TRUE	FALSE
yheS	FALSE	TRUE	FALSE
yheT	FALSE	TRUE	FALSE
yheU	FALSE	TRUE	FALSE
prkB	FALSE	TRUE	FALSE
yhfA	FALSE	TRUE	FALSE
crp	TRUE	FALSE	FALSE
yhfK	FALSE	TRUE	FALSE
argD	FALSE	TRUE	FALSE
pabA	FALSE	TRUE	FALSE
fic	FALSE	TRUE	FALSE
yhfG	FALSE	TRUE	FALSE
ppiA	FALSE	TRUE	FALSE
tsgA	FALSE	TRUE	FALSE
nirB	FALSE	TRUE	FALSE
nirD	FALSE	TRUE	FALSE
nirC	FALSE	TRUE	FALSE
cysG	FALSE	TRUE	FALSE
yhfL	FALSE	TRUE	FALSE
frlA	FALSE	TRUE	FALSE
frlB	FALSE	TRUE	FALSE
frlC	FALSE	TRUE	FALSE
frlD	FALSE	TRUE	FALSE
frlR	FALSE	TRUE	FALSE
yhfS	FALSE	TRUE	FALSE
yhfT	FALSE	TRUE	FALSE
yhfU	FALSE	TRUE	FALSE
php	FALSE	TRUE	FALSE
yhfW	FALSE	TRUE	FALSE
yhfX	FALSE	TRUE	FALSE
yhfY	FALSE	TRUE	FALSE
yhfZ	FALSE	TRUE	FALSE
trpS	TRUE	FALSE	FALSE
gph	FALSE	TRUE	FALSE
rpe	TRUE	FALSE	FALSE
dam	FALSE	TRUE	FALSE
damX	FALSE	TRUE	FALSE
aroB	FALSE	TRUE	FALSE
aroK	FALSE	TRUE	FALSE
hofQ	FALSE	TRUE	FALSE
hofP	FALSE	TRUE	FALSE
hofO	FALSE	TRUE	FALSE
hofN	FALSE	TRUE	FALSE
hofM	FALSE	TRUE	FALSE
mrcA	FALSE	TRUE	FALSE
nudE	FALSE	TRUE	FALSE
yrfF	TRUE	FALSE	FALSE
yrfG	FALSE	TRUE	FALSE
hslR	FALSE	TRUE	FALSE
hslO	FALSE	TRUE	FALSE
yhgE	FALSE	TRUE	FALSE
pck	FALSE	TRUE	FALSE
envZ	FALSE	TRUE	FALSE
ompR	FALSE	TRUE	FALSE
greB	FALSE	TRUE	FALSE
yhgF	FALSE	TRUE	FALSE
feoA	FALSE	TRUE	FALSE
feoB	FALSE	TRUE	FALSE
feoC	FALSE	TRUE	FALSE
yhgA	FALSE	TRUE	FALSE
bioH	FALSE	TRUE	FALSE
gntX	FALSE	TRUE	FALSE
nfuA	FALSE	TRUE	FALSE
gntT	FALSE	TRUE	FALSE
malQ	FALSE	TRUE	FALSE
malP	FALSE	TRUE	FALSE
malT	FALSE	TRUE	FALSE
rtcA	FALSE	TRUE	FALSE
rtcB	FALSE	TRUE	FALSE
rtcR	FALSE	TRUE	FALSE
glpR	FALSE	TRUE	FALSE
glpG	FALSE	TRUE	FALSE
glpE	FALSE	TRUE	FALSE
glpD	FALSE	TRUE	FALSE
yzgL	FALSE	TRUE	FALSE
glgP	FALSE	TRUE	FALSE
glgA	FALSE	TRUE	FALSE
glgC	FALSE	TRUE	FALSE
glgX	FALSE	TRUE	FALSE
glgB	FALSE	TRUE	FALSE
asd	TRUE	FALSE	FALSE
yhgN	FALSE	TRUE	FALSE
gntU	FALSE	TRUE	FALSE
gntK	FALSE	TRUE	FALSE
gntR	FALSE	TRUE	FALSE
yhhW	FALSE	TRUE	FALSE
yhhX	FALSE	TRUE	FALSE
yhhY	FALSE	TRUE	FALSE
yhhZ	FALSE	TRUE	FALSE
yrhA	FALSE	TRUE	FALSE
insA	FALSE	TRUE	FALSE
insB1	FALSE	TRUE	FALSE
yrhB	FALSE	TRUE	FALSE
ggt	FALSE	TRUE	FALSE
yhhA	FALSE	TRUE	FALSE
ugpQ	FALSE	TRUE	FALSE
ugpC	FALSE	TRUE	FALSE
ugpE	FALSE	TRUE	FALSE
ugpA	FALSE	TRUE	FALSE
ugpB	FALSE	TRUE	FALSE
livF	FALSE	TRUE	FALSE
livG	FALSE	TRUE	FALSE
livM	FALSE	TRUE	FALSE
livH	FALSE	TRUE	FALSE
livK	FALSE	TRUE	FALSE
panM	FALSE	TRUE	FALSE
livJ	FALSE	TRUE	FALSE
rpoH	TRUE	FALSE	FALSE
ftsX	FALSE	TRUE	FALSE
ftsE	FALSE	TRUE	FALSE
ftsY	TRUE	FALSE	FALSE
rsmD	FALSE	TRUE	FALSE
yhhL	FALSE	TRUE	FALSE
yhhM	FALSE	TRUE	FALSE
yhhN	FALSE	TRUE	FALSE
zntA	FALSE	TRUE	FALSE
tusA	FALSE	FALSE	TRUE
yhhQ	FALSE	TRUE	FALSE
dcrB	FALSE	TRUE	FALSE
yhhS	FALSE	TRUE	FALSE
yhhT	FALSE	TRUE	FALSE
acpT	FALSE	TRUE	FALSE
nikA	FALSE	TRUE	FALSE
nikB	FALSE	TRUE	FALSE
nikC	FALSE	TRUE	FALSE
nikD	FALSE	TRUE	FALSE
nikE	FALSE	TRUE	FALSE
nikR	FALSE	TRUE	FALSE
rhsB	FALSE	TRUE	FALSE
yhhH	FALSE	TRUE	FALSE
yrhC	FALSE	TRUE	FALSE
yhhI	FALSE	TRUE	FALSE
yhhJ	FALSE	TRUE	FALSE
rbbA	FALSE	TRUE	FALSE
yhiI	FALSE	TRUE	FALSE
yhiJ	FALSE	TRUE	FALSE
yhiL	FALSE	TRUE	FALSE
yhiM	FALSE	TRUE	FALSE
yhiN	FALSE	TRUE	FALSE
pitA	FALSE	TRUE	FALSE
uspB	FALSE	TRUE	FALSE
uspA	FALSE	TRUE	FALSE
dtpB	FALSE	TRUE	FALSE
rsmJ	FALSE	TRUE	FALSE
prlC	FALSE	TRUE	FALSE
rlmJ	FALSE	TRUE	FALSE
gor	FALSE	TRUE	FALSE
dinQ	FALSE	TRUE	FALSE
arsR	FALSE	TRUE	FALSE
arsB	FALSE	TRUE	FALSE
arsC	FALSE	TRUE	FALSE
yhiS	FALSE	TRUE	FALSE
insH1	FALSE	TRUE	FALSE
slp	FALSE	TRUE	FALSE
dctR	FALSE	TRUE	FALSE
yhiD	FALSE	TRUE	FALSE
hdeB	FALSE	TRUE	FALSE
hdeA	FALSE	TRUE	FALSE
hdeD	FALSE	TRUE	FALSE
gadE	FALSE	TRUE	FALSE
mdtE	FALSE	TRUE	FALSE
mdtF	FALSE	TRUE	FALSE
gadW	FALSE	TRUE	FALSE
gadX	FALSE	TRUE	FALSE
gadA	FALSE	TRUE	FALSE
yhjA	FALSE	TRUE	FALSE
treF	FALSE	TRUE	FALSE
yhjB	FALSE	TRUE	FALSE
yhjC	FALSE	TRUE	FALSE
yhjD	FALSE	TRUE	FALSE
yhjE	FALSE	TRUE	FALSE
yhjG	FALSE	TRUE	FALSE
yhjH	FALSE	TRUE	FALSE
kdgK	FALSE	TRUE	FALSE
yhjJ	FALSE	TRUE	FALSE
dctA	FALSE	TRUE	FALSE
yhjK	FALSE	TRUE	FALSE
bcsC	FALSE	TRUE	FALSE
bcsZ	FALSE	TRUE	FALSE
bcsB	FALSE	TRUE	FALSE
bcsA	FALSE	TRUE	FALSE
bcsQ	FALSE	TRUE	FALSE
yhjR	FALSE	TRUE	FALSE
bcsE	FALSE	TRUE	FALSE
bcsF	FALSE	TRUE	FALSE
bcsG	FALSE	TRUE	FALSE
ldrD	FALSE	TRUE	FALSE
yhjV	FALSE	TRUE	FALSE
dppF	FALSE	TRUE	FALSE
dppD	FALSE	TRUE	FALSE
dppC	FALSE	TRUE	FALSE
dppB	FALSE	TRUE	FALSE
dppA	FALSE	TRUE	FALSE
eptB	FALSE	TRUE	FALSE
yhjX	FALSE	TRUE	FALSE
yhjY	FALSE	TRUE	FALSE
tag	FALSE	TRUE	FALSE
yiaC	FALSE	TRUE	FALSE
bisC	FALSE	TRUE	FALSE
yiaD	FALSE	TRUE	FALSE
ghrB	FALSE	TRUE	FALSE
yiaF	FALSE	TRUE	FALSE
yiaG	FALSE	TRUE	FALSE
cspA	FALSE	TRUE	FALSE
mokA	FALSE	TRUE	FALSE
hokA	FALSE	TRUE	FALSE
insJ	FALSE	TRUE	FALSE
insK	FALSE	TRUE	FALSE
glyS	TRUE	FALSE	FALSE
glyQ	TRUE	FALSE	FALSE
ysaB	FALSE	TRUE	FALSE
wecH	FALSE	TRUE	FALSE
yiaA	FALSE	TRUE	FALSE
yiaB	FALSE	TRUE	FALSE
xylB	FALSE	TRUE	FALSE
xylA	FALSE	TRUE	FALSE
xylF	FALSE	TRUE	FALSE
xylG	FALSE	TRUE	FALSE
xylH	FALSE	TRUE	FALSE
xylR	FALSE	TRUE	FALSE
bax	FALSE	TRUE	FALSE
malS	FALSE	TRUE	FALSE
avtA	FALSE	TRUE	FALSE
ysaA	FALSE	TRUE	FALSE
yiaJ	FALSE	TRUE	FALSE
yiaK	FALSE	TRUE	FALSE
yiaL	FALSE	TRUE	FALSE
yiaM	FALSE	TRUE	FALSE
yiaN	FALSE	TRUE	FALSE
yiaO	FALSE	TRUE	FALSE
lyxK	FALSE	TRUE	FALSE
sgbH	FALSE	TRUE	FALSE
sgbU	FALSE	TRUE	FALSE
sgbE	FALSE	TRUE	FALSE
ysaC	FALSE	TRUE	FALSE
ysaD	FALSE	TRUE	FALSE
yiaT	FALSE	TRUE	FALSE
yiaU	FALSE	TRUE	FALSE
yiaV	FALSE	TRUE	FALSE
yiaW	FALSE	TRUE	FALSE
aldB	FALSE	TRUE	FALSE
yiaY	FALSE	TRUE	FALSE
selB	FALSE	TRUE	FALSE
selA	FALSE	TRUE	FALSE
yibF	FALSE	TRUE	FALSE
rhsA	FALSE	TRUE	FALSE
yibA	FALSE	TRUE	FALSE
rhsJ	FALSE	TRUE	FALSE
yibG	FALSE	TRUE	FALSE
yibS	FALSE	TRUE	FALSE
yibW	FALSE	TRUE	FALSE
yibV	FALSE	FALSE	TRUE
yibU	FALSE	TRUE	FALSE
yibH	FALSE	TRUE	FALSE
yibI	FALSE	TRUE	FALSE
mtlA	FALSE	TRUE	FALSE
mtlD	FALSE	TRUE	FALSE
mtlR	FALSE	TRUE	FALSE
yibT	FALSE	TRUE	FALSE
yibL	FALSE	TRUE	FALSE
lldP	FALSE	TRUE	FALSE
lldR	FALSE	TRUE	FALSE
lldD	FALSE	TRUE	FALSE
trmL	FALSE	TRUE	FALSE
cysE	FALSE	TRUE	FALSE
gpsA	TRUE	FALSE	FALSE
secB	FALSE	TRUE	FALSE
grxC	FALSE	TRUE	FALSE
yibN	FALSE	TRUE	FALSE
gpmM	FALSE	TRUE	FALSE
envC	FALSE	TRUE	FALSE
yibQ	FALSE	TRUE	FALSE
waaH	FALSE	TRUE	FALSE
tdh	FALSE	TRUE	FALSE
kbl	FALSE	TRUE	FALSE
yibB	FALSE	TRUE	FALSE
hldD	FALSE	TRUE	FALSE
waaF	FALSE	TRUE	FALSE
waaC	FALSE	TRUE	FALSE
waaL	FALSE	TRUE	FALSE
waaU	FALSE	TRUE	FALSE
waaZ	FALSE	TRUE	FALSE
waaY	FALSE	TRUE	FALSE
waaJ	FALSE	TRUE	FALSE
waaR	FALSE	TRUE	FALSE
waaB	FALSE	TRUE	FALSE
waaS	FALSE	TRUE	FALSE
waaP	FALSE	TRUE	FALSE
waaG	FALSE	TRUE	FALSE
waaQ	FALSE	TRUE	FALSE
waaA	TRUE	FALSE	FALSE
coaD	TRUE	FALSE	FALSE
mutM	FALSE	TRUE	FALSE
rpmG	FALSE	TRUE	FALSE
rpmB	TRUE	FALSE	FALSE
yicR	FALSE	TRUE	FALSE
dfp	TRUE	FALSE	FALSE
dut	TRUE	FALSE	FALSE
slmA	FALSE	TRUE	FALSE
pyrE	FALSE	TRUE	FALSE
rph	FALSE	TRUE	FALSE
yicC	FALSE	TRUE	FALSE
dinD	FALSE	TRUE	FALSE
yicG	FALSE	TRUE	FALSE
ligB	FALSE	TRUE	FALSE
gmk	TRUE	FALSE	FALSE
rpoZ	FALSE	TRUE	FALSE
spoT	FALSE	TRUE	FALSE
trmH	FALSE	TRUE	FALSE
recG	FALSE	TRUE	FALSE
gltS	FALSE	TRUE	FALSE
xanP	FALSE	TRUE	FALSE
yicH	FALSE	TRUE	FALSE
yicI	FALSE	TRUE	FALSE
yicJ	FALSE	TRUE	FALSE
yicT	FALSE	TRUE	FALSE
setC	FALSE	TRUE	FALSE
yicL	FALSE	TRUE	FALSE
nlpA	FALSE	TRUE	FALSE
yicS	FALSE	TRUE	FALSE
nepI	FALSE	TRUE	FALSE
yicN	FALSE	TRUE	FALSE
yicO	FALSE	TRUE	FALSE
ade	FALSE	TRUE	FALSE
uhpT	FALSE	TRUE	FALSE
uhpC	FALSE	TRUE	FALSE
uhpB	FALSE	TRUE	FALSE
uhpA	FALSE	TRUE	FALSE
ilvN	FALSE	TRUE	FALSE
ilvB	FALSE	TRUE	FALSE
ivbL	FALSE	TRUE	FALSE
tisB	FALSE	TRUE	FALSE
emrD	FALSE	TRUE	FALSE
yidF	FALSE	TRUE	FALSE
yidG	FALSE	TRUE	FALSE
yidH	FALSE	TRUE	FALSE
yidI	FALSE	TRUE	FALSE
yidJ	FALSE	TRUE	FALSE
yidK	FALSE	TRUE	FALSE
yidL	FALSE	TRUE	FALSE
glvG	FALSE	TRUE	FALSE
glvC	FALSE	TRUE	FALSE
yidP	FALSE	TRUE	FALSE
yidE	FALSE	TRUE	FALSE
ibpB	FALSE	TRUE	FALSE
ibpA	FALSE	TRUE	FALSE
yidQ	FALSE	TRUE	FALSE
yidR	FALSE	TRUE	FALSE
cbrA	FALSE	TRUE	FALSE
dgoT	FALSE	TRUE	FALSE
dgoD	FALSE	TRUE	FALSE
dgoA	FALSE	TRUE	FALSE
dgoK	FALSE	TRUE	FALSE
dgoR	FALSE	TRUE	FALSE
yidX	FALSE	TRUE	FALSE
yidA	FALSE	TRUE	FALSE
yidB	FALSE	TRUE	FALSE
gyrB	TRUE	FALSE	FALSE
recF	FALSE	TRUE	FALSE
dnaN	TRUE	FALSE	FALSE
dnaA	TRUE	FALSE	FALSE
rpmH	TRUE	FALSE	FALSE
rnpA	FALSE	FALSE	TRUE
yidD	FALSE	TRUE	FALSE
yidC	TRUE	FALSE	FALSE
mnmE	FALSE	TRUE	FALSE
tnaC	FALSE	TRUE	FALSE
tnaA	FALSE	TRUE	FALSE
tnaB	FALSE	TRUE	FALSE
mdtL	FALSE	TRUE	FALSE
yidZ	FALSE	TRUE	FALSE
yieE	FALSE	TRUE	FALSE
chrR	FALSE	TRUE	FALSE
purP	FALSE	TRUE	FALSE
yieH	FALSE	TRUE	FALSE
cbrB	FALSE	TRUE	FALSE
cbrC	FALSE	TRUE	FALSE
yieK	FALSE	TRUE	FALSE
yieL	FALSE	TRUE	FALSE
bglH	FALSE	TRUE	FALSE
bglB	FALSE	TRUE	FALSE
bglF	FALSE	TRUE	FALSE
bglG	FALSE	TRUE	FALSE
phoU	FALSE	TRUE	FALSE
pstB	FALSE	TRUE	FALSE
pstA	FALSE	TRUE	FALSE
pstC	FALSE	TRUE	FALSE
pstS	FALSE	TRUE	FALSE
glmS	TRUE	FALSE	FALSE
glmU	TRUE	FALSE	FALSE
atpC	FALSE	TRUE	FALSE
atpD	FALSE	TRUE	FALSE
atpG	FALSE	TRUE	FALSE
atpA	FALSE	TRUE	FALSE
atpH	FALSE	TRUE	FALSE
atpF	FALSE	TRUE	FALSE
atpE	FALSE	TRUE	FALSE
atpB	FALSE	TRUE	FALSE
atpI	FALSE	TRUE	FALSE
rsmG	FALSE	TRUE	FALSE
mnmG	FALSE	TRUE	FALSE
mioC	FALSE	TRUE	FALSE
asnC	FALSE	TRUE	FALSE
asnA	FALSE	TRUE	FALSE
viaA	FALSE	TRUE	FALSE
ravA	FALSE	TRUE	FALSE
kup	FALSE	TRUE	FALSE
rbsD	FALSE	TRUE	FALSE
rbsA	FALSE	TRUE	FALSE
rbsC	FALSE	TRUE	FALSE
rbsB	FALSE	TRUE	FALSE
rbsK	FALSE	TRUE	FALSE
rbsR	FALSE	TRUE	FALSE
hsrA	FALSE	TRUE	FALSE
yieP	FALSE	TRUE	FALSE
hdfR	FALSE	TRUE	FALSE
yifE	FALSE	TRUE	FALSE
yifB	FALSE	TRUE	FALSE
ilvL	FALSE	TRUE	FALSE
ilvX	FALSE	TRUE	FALSE
ilvG	FALSE	TRUE	FALSE
ilvM	FALSE	TRUE	FALSE
ilvE	FALSE	TRUE	FALSE
ilvD	FALSE	TRUE	FALSE
ilvA	FALSE	TRUE	FALSE
ilvY	FALSE	TRUE	FALSE
ilvC	FALSE	TRUE	FALSE
ppiC	FALSE	TRUE	FALSE
yifN	FALSE	TRUE	FALSE
rep	FALSE	TRUE	FALSE
gpp	FALSE	TRUE	FALSE
rhlB	FALSE	TRUE	FALSE
trxA	FALSE	TRUE	FALSE
rho	TRUE	FALSE	FALSE
wecA	FALSE	TRUE	FALSE
wzzE	FALSE	TRUE	FALSE
wecB	FALSE	TRUE	FALSE
wecC	FALSE	TRUE	FALSE
rffG	FALSE	TRUE	FALSE
rffH	FALSE	TRUE	FALSE
wecD	FALSE	TRUE	FALSE
wecE	FALSE	TRUE	FALSE
wzxE	FALSE	TRUE	FALSE
wecF	FALSE	TRUE	FALSE
wzyE	TRUE	FALSE	FALSE
wecG	FALSE	TRUE	FALSE
yifK	FALSE	TRUE	FALSE
aslB	FALSE	TRUE	FALSE
aslA	FALSE	TRUE	FALSE
hemY	FALSE	TRUE	FALSE
hemX	FALSE	TRUE	FALSE
hemD	TRUE	FALSE	FALSE
hemC	TRUE	FALSE	FALSE
cyaA	FALSE	TRUE	FALSE
cyaY	FALSE	TRUE	FALSE
yifL	FALSE	TRUE	FALSE
dapF	FALSE	FALSE	TRUE
yigA	FALSE	TRUE	FALSE
xerC	FALSE	TRUE	FALSE
yigB	FALSE	TRUE	FALSE
uvrD	FALSE	TRUE	FALSE
yigE	FALSE	TRUE	FALSE
corA	FALSE	TRUE	FALSE
yigF	FALSE	TRUE	FALSE
yigG	FALSE	TRUE	FALSE
rarD	FALSE	TRUE	FALSE
yigI	FALSE	TRUE	FALSE
pldA	FALSE	TRUE	FALSE
recQ	FALSE	TRUE	FALSE
rhtC	FALSE	TRUE	FALSE
rhtB	FALSE	TRUE	FALSE
pldB	FALSE	TRUE	FALSE
yigL	FALSE	TRUE	FALSE
yigM	FALSE	TRUE	FALSE
metR	FALSE	TRUE	FALSE
metE	FALSE	TRUE	FALSE
ysgA	FALSE	TRUE	FALSE
udp	FALSE	TRUE	FALSE
rmuC	FALSE	TRUE	FALSE
ubiE	TRUE	FALSE	FALSE
ubiJ	FALSE	TRUE	FALSE
ubiB	TRUE	FALSE	FALSE
tatA	FALSE	TRUE	FALSE
tatB	FALSE	TRUE	FALSE
tatC	FALSE	TRUE	FALSE
tatD	FALSE	TRUE	FALSE
rfaH	FALSE	TRUE	FALSE
ubiD	TRUE	FALSE	FALSE
fre	FALSE	TRUE	FALSE
fadA	FALSE	TRUE	FALSE
fadB	FALSE	TRUE	FALSE
pepQ	FALSE	TRUE	FALSE
yigZ	FALSE	TRUE	FALSE
trkH	FALSE	TRUE	FALSE
hemG	TRUE	FALSE	FALSE
mobB	FALSE	TRUE	FALSE
mobA	FALSE	TRUE	FALSE
yihD	FALSE	TRUE	FALSE
srkA	FALSE	TRUE	FALSE
dsbA	FALSE	TRUE	FALSE
yihF	FALSE	TRUE	FALSE
yihG	FALSE	TRUE	FALSE
polA	FALSE	TRUE	FALSE
yihA	TRUE	FALSE	FALSE
yihI	FALSE	TRUE	FALSE
hemN	FALSE	TRUE	FALSE
yshB	FALSE	TRUE	FALSE
glnG	FALSE	TRUE	FALSE
glnL	FALSE	TRUE	FALSE
glnA	FALSE	TRUE	FALSE
typA	FALSE	TRUE	FALSE
yihL	FALSE	TRUE	FALSE
yihM	FALSE	TRUE	FALSE
yihN	FALSE	TRUE	FALSE
ompL	FALSE	TRUE	FALSE
yihO	FALSE	TRUE	FALSE
yihP	FALSE	TRUE	FALSE
yihQ	FALSE	TRUE	FALSE
yihR	FALSE	TRUE	FALSE
yihS	FALSE	TRUE	FALSE
yihT	FALSE	TRUE	FALSE
yihU	FALSE	TRUE	FALSE
yihV	FALSE	TRUE	FALSE
yihW	FALSE	TRUE	FALSE
yihX	FALSE	TRUE	FALSE
yihY	FALSE	TRUE	FALSE
dtd	FALSE	TRUE	FALSE
yiiD	FALSE	TRUE	FALSE
yiiE	FALSE	TRUE	FALSE
yiiF	FALSE	TRUE	FALSE
fdhE	FALSE	TRUE	FALSE
fdoI	FALSE	TRUE	FALSE
fdoH	FALSE	TRUE	FALSE
fdoG	FALSE	TRUE	FALSE
fdhD	FALSE	TRUE	FALSE
yiiG	FALSE	TRUE	FALSE
frvR	FALSE	TRUE	FALSE
frvX	FALSE	TRUE	FALSE
frvB	FALSE	TRUE	FALSE
frvA	FALSE	TRUE	FALSE
rhaM	FALSE	TRUE	FALSE
rhaD	FALSE	TRUE	FALSE
rhaS	FALSE	TRUE	FALSE
rhaR	FALSE	TRUE	FALSE
rhaT	FALSE	TRUE	FALSE
sodA	FALSE	TRUE	FALSE
kdgT	FALSE	TRUE	FALSE
yiiM	FALSE	TRUE	FALSE
cpxA	FALSE	TRUE	FALSE
cpxR	FALSE	TRUE	FALSE
cpxP	FALSE	TRUE	FALSE
fieF	FALSE	TRUE	FALSE
pfkA	FALSE	TRUE	FALSE
sbp	FALSE	TRUE	FALSE
cdh	FALSE	TRUE	FALSE
tpiA	FALSE	TRUE	FALSE
yiiQ	FALSE	TRUE	FALSE
yiiR	FALSE	TRUE	FALSE
yiiS	FALSE	TRUE	FALSE
uspD	FALSE	TRUE	FALSE
fpr	FALSE	TRUE	FALSE
glpX	FALSE	TRUE	FALSE
glpK	FALSE	TRUE	FALSE
glpF	FALSE	TRUE	FALSE
zapB	FALSE	TRUE	FALSE
rraA	FALSE	TRUE	FALSE
menA	FALSE	TRUE	FALSE
hslU	FALSE	TRUE	FALSE
hslV	FALSE	TRUE	FALSE
ftsN	FALSE	TRUE	FALSE
cytR	FALSE	TRUE	FALSE
priA	FALSE	FALSE	TRUE
rpmE	FALSE	FALSE	TRUE
yiiX	FALSE	TRUE	FALSE
metJ	FALSE	TRUE	FALSE
metB	FALSE	TRUE	FALSE
metL	FALSE	TRUE	FALSE
metF	FALSE	TRUE	FALSE
katG	FALSE	TRUE	FALSE
yijE	FALSE	TRUE	FALSE
yijF	FALSE	TRUE	FALSE
gldA	FALSE	TRUE	FALSE
fsaB	FALSE	TRUE	FALSE
frwA	FALSE	TRUE	FALSE
frwC	FALSE	TRUE	FALSE
frwB	FALSE	TRUE	FALSE
pflD	FALSE	TRUE	FALSE
pflC	FALSE	TRUE	FALSE
frwD	FALSE	TRUE	FALSE
yijO	FALSE	TRUE	FALSE
eptC	FALSE	TRUE	FALSE
ppc	FALSE	TRUE	FALSE
argE	FALSE	TRUE	FALSE
argC	FALSE	TRUE	FALSE
argB	FALSE	TRUE	FALSE
argH	FALSE	TRUE	FALSE
oxyR	FALSE	TRUE	FALSE
sthA	FALSE	TRUE	FALSE
fabR	FALSE	TRUE	FALSE
yijD	FALSE	TRUE	FALSE
trmA	FALSE	TRUE	FALSE
btuB	FALSE	TRUE	FALSE
murI	TRUE	FALSE	FALSE
murB	TRUE	FALSE	FALSE
birA	TRUE	FALSE	FALSE
coaA	TRUE	FALSE	FALSE
tufB	FALSE	TRUE	FALSE
secE	TRUE	FALSE	FALSE
nusG	TRUE	FALSE	FALSE
rplK	TRUE	FALSE	FALSE
rplA	TRUE	FALSE	FALSE
rplJ	TRUE	FALSE	FALSE
rplL	TRUE	FALSE	FALSE
rpoB	TRUE	FALSE	FALSE
rpoC	TRUE	FALSE	FALSE
yjaZ	FALSE	TRUE	FALSE
thiH	FALSE	TRUE	FALSE
thiG	FALSE	TRUE	FALSE
thiS	FALSE	TRUE	FALSE
thiF	FALSE	TRUE	FALSE
thiE	FALSE	TRUE	FALSE
thiC	FALSE	TRUE	FALSE
rsd	FALSE	TRUE	FALSE
nudC	FALSE	TRUE	FALSE
hemE	TRUE	FALSE	FALSE
nfi	FALSE	TRUE	FALSE
yjaG	FALSE	TRUE	FALSE
hupA	FALSE	TRUE	FALSE
yjaH	FALSE	TRUE	FALSE
zraP	FALSE	TRUE	FALSE
zraS	FALSE	TRUE	FALSE
zraR	FALSE	TRUE	FALSE
purD	FALSE	TRUE	FALSE
purH	FALSE	TRUE	FALSE
yjaA	FALSE	TRUE	FALSE
yjaB	FALSE	TRUE	FALSE
metA	FALSE	TRUE	FALSE
aceB	FALSE	TRUE	FALSE
aceA	FALSE	TRUE	FALSE
aceK	FALSE	TRUE	FALSE
arpA	FALSE	TRUE	FALSE
iclR	FALSE	TRUE	FALSE
metH	FALSE	TRUE	FALSE
yjbB	FALSE	TRUE	FALSE
pepE	FALSE	TRUE	FALSE
rluF	FALSE	TRUE	FALSE
yjbD	FALSE	TRUE	FALSE
lysC	FALSE	TRUE	FALSE
pgi	FALSE	TRUE	FALSE
yjbE	FALSE	TRUE	FALSE
yjbF	FALSE	TRUE	FALSE
yjbG	FALSE	TRUE	FALSE
yjbH	FALSE	TRUE	FALSE
yjbT	FALSE	TRUE	FALSE
psiE	FALSE	TRUE	FALSE
xylE	FALSE	TRUE	FALSE
malG	FALSE	TRUE	FALSE
malF	FALSE	TRUE	FALSE
malE	FALSE	TRUE	FALSE
malK	FALSE	TRUE	FALSE
lamB	FALSE	TRUE	FALSE
malM	FALSE	TRUE	FALSE
yjbI	FALSE	TRUE	FALSE
ubiC	FALSE	TRUE	FALSE
ubiA	TRUE	FALSE	FALSE
plsB	TRUE	FALSE	FALSE
dgkA	FALSE	TRUE	FALSE
lexA	TRUE	FALSE	FALSE
dinF	FALSE	TRUE	FALSE
yjbJ	FALSE	TRUE	FALSE
zur	FALSE	TRUE	FALSE
yjbL	FALSE	FALSE	TRUE
yjbM	FALSE	TRUE	FALSE
dusA	FALSE	TRUE	FALSE
pspG	FALSE	TRUE	FALSE
qorA	FALSE	TRUE	FALSE
dnaB	TRUE	FALSE	FALSE
alr	FALSE	TRUE	FALSE
tyrB	FALSE	TRUE	FALSE
yjbS	TRUE	FALSE	FALSE
aphA	FALSE	TRUE	FALSE
yjbQ	FALSE	TRUE	FALSE
yjbR	FALSE	TRUE	FALSE
uvrA	FALSE	TRUE	FALSE
ssb	TRUE	FALSE	FALSE
yjcB	FALSE	TRUE	FALSE
yjcC	FALSE	TRUE	FALSE
soxS	FALSE	TRUE	FALSE
soxR	FALSE	TRUE	FALSE
yjcD	FALSE	TRUE	FALSE
yjcE	FALSE	TRUE	FALSE
yjcF	FALSE	TRUE	FALSE
actP	FALSE	TRUE	FALSE
yjcH	FALSE	TRUE	FALSE
acs	FALSE	TRUE	FALSE
nrfA	FALSE	TRUE	FALSE
nrfB	FALSE	TRUE	FALSE
nrfC	FALSE	TRUE	FALSE
nrfD	FALSE	TRUE	FALSE
nrfE	FALSE	TRUE	FALSE
nrfF	FALSE	TRUE	FALSE
nrfG	FALSE	TRUE	FALSE
gltP	FALSE	TRUE	FALSE
yjcO	FALSE	TRUE	FALSE
fdhF	FALSE	TRUE	FALSE
mdtP	FALSE	TRUE	FALSE
mdtO	FALSE	TRUE	FALSE
mdtN	FALSE	TRUE	FALSE
ytcA	FALSE	TRUE	FALSE
yjcS	FALSE	TRUE	FALSE
alsK	FALSE	TRUE	FALSE
alsE	FALSE	TRUE	FALSE
alsC	FALSE	TRUE	FALSE
alsA	FALSE	TRUE	FALSE
alsB	FALSE	TRUE	FALSE
alsR	FALSE	TRUE	FALSE
rpiB	FALSE	TRUE	FALSE
yjdP	FALSE	TRUE	FALSE
phnP	FALSE	TRUE	FALSE
phnO	FALSE	TRUE	FALSE
phnN	FALSE	TRUE	FALSE
phnM	FALSE	TRUE	FALSE
phnL	FALSE	TRUE	FALSE
phnK	FALSE	TRUE	FALSE
phnJ	FALSE	TRUE	FALSE
phnI	FALSE	TRUE	FALSE
phnH	FALSE	TRUE	FALSE
phnG	FALSE	TRUE	FALSE
phnF	FALSE	TRUE	FALSE
phnE	FALSE	TRUE	FALSE
phnD	FALSE	TRUE	FALSE
phnC	FALSE	TRUE	FALSE
yjdN	FALSE	TRUE	FALSE
yjdM	FALSE	TRUE	FALSE
crfC	FALSE	TRUE	FALSE
yjcZ	FALSE	TRUE	FALSE
proP	FALSE	TRUE	FALSE
pmrR	FALSE	TRUE	FALSE
basS	FALSE	TRUE	FALSE
basR	FALSE	TRUE	FALSE
eptA	FALSE	TRUE	FALSE
adiC	FALSE	TRUE	FALSE
adiY	FALSE	TRUE	FALSE
adiA	FALSE	TRUE	FALSE
melR	FALSE	TRUE	FALSE
melA	FALSE	TRUE	FALSE
melB	FALSE	TRUE	FALSE
yjdF	FALSE	TRUE	FALSE
fumB	FALSE	TRUE	FALSE
dcuB	FALSE	TRUE	FALSE
dcuR	FALSE	TRUE	FALSE
dcuS	FALSE	TRUE	FALSE
yjdI	FALSE	TRUE	FALSE
yjdJ	FALSE	TRUE	FALSE
yjdK	FALSE	TRUE	FALSE
yjdO	FALSE	TRUE	FALSE
lysU	FALSE	TRUE	FALSE
dtpC	FALSE	TRUE	FALSE
cadA	FALSE	TRUE	FALSE
cadB	FALSE	TRUE	FALSE
cadC	FALSE	TRUE	FALSE
yjdQ	FALSE	TRUE	FALSE
yjdC	FALSE	TRUE	FALSE
dsbD	FALSE	TRUE	FALSE
cutA	FALSE	TRUE	FALSE
dcuA	FALSE	TRUE	FALSE
aspA	FALSE	TRUE	FALSE
fxsA	FALSE	TRUE	FALSE
yjeH	FALSE	TRUE	FALSE
groS	TRUE	FALSE	FALSE
groL	TRUE	FALSE	FALSE
yjeI	FALSE	TRUE	FALSE
yjeJ	FALSE	TRUE	FALSE
epmB	FALSE	TRUE	FALSE
efp	TRUE	FALSE	FALSE
ecnA	FALSE	TRUE	FALSE
ecnB	FALSE	TRUE	FALSE
sugE	FALSE	TRUE	FALSE
blc	FALSE	TRUE	FALSE
ampC	FALSE	TRUE	FALSE
frdD	FALSE	TRUE	FALSE
frdC	FALSE	TRUE	FALSE
frdB	FALSE	TRUE	FALSE
frdA	FALSE	TRUE	FALSE
epmA	FALSE	TRUE	FALSE
yjeM	FALSE	TRUE	FALSE
yjeN	FALSE	TRUE	FALSE
yjeO	FALSE	TRUE	FALSE
mscM	FALSE	TRUE	FALSE
psd	FALSE	FALSE	TRUE
rsgA	TRUE	FALSE	FALSE
orn	TRUE	FALSE	FALSE
yjeV	FALSE	TRUE	FALSE
queG	FALSE	TRUE	FALSE
nnr	FALSE	TRUE	FALSE
tsaE	TRUE	FALSE	FALSE
amiB	FALSE	TRUE	FALSE
mutL	FALSE	TRUE	FALSE
miaA	FALSE	TRUE	FALSE
hfq	FALSE	TRUE	FALSE
hflX	FALSE	TRUE	FALSE
hflK	FALSE	TRUE	FALSE
hflC	FALSE	TRUE	FALSE
yjeT	FALSE	TRUE	FALSE
purA	FALSE	TRUE	FALSE
nsrR	FALSE	TRUE	FALSE
rnr	FALSE	TRUE	FALSE
rlmB	FALSE	TRUE	FALSE
yjfI	FALSE	TRUE	FALSE
yjfJ	FALSE	TRUE	FALSE
yjfK	FALSE	TRUE	FALSE
yjfL	FALSE	TRUE	FALSE
yjfM	FALSE	TRUE	FALSE
yjfC	FALSE	TRUE	FALSE
aidB	FALSE	TRUE	FALSE
yjfN	FALSE	TRUE	FALSE
bsmA	FALSE	TRUE	FALSE
yjfP	FALSE	TRUE	FALSE
ulaR	FALSE	TRUE	FALSE
ulaG	FALSE	TRUE	FALSE
ulaA	FALSE	TRUE	FALSE
ulaB	FALSE	TRUE	FALSE
ulaC	FALSE	TRUE	FALSE
ulaD	FALSE	TRUE	FALSE
ulaE	FALSE	TRUE	FALSE
ulaF	FALSE	TRUE	FALSE
yjfY	FALSE	TRUE	FALSE
rpsF	TRUE	FALSE	FALSE
priB	TRUE	FALSE	FALSE
rpsR	TRUE	FALSE	FALSE
rplI	FALSE	TRUE	FALSE
yjfZ	FALSE	TRUE	FALSE
ytfA	FALSE	TRUE	FALSE
ytfB	FALSE	TRUE	FALSE
fklB	FALSE	TRUE	FALSE
cycA	FALSE	TRUE	FALSE
ytfE	FALSE	TRUE	FALSE
ytfF	FALSE	TRUE	FALSE
qorB	FALSE	TRUE	FALSE
ytfH	FALSE	TRUE	FALSE
cpdB	FALSE	TRUE	FALSE
cysQ	FALSE	TRUE	FALSE
ytfI	FALSE	TRUE	FALSE
ytfJ	FALSE	TRUE	FALSE
ytfK	FALSE	TRUE	FALSE
ytfL	FALSE	TRUE	FALSE
msrA	FALSE	TRUE	FALSE
tamA	FALSE	TRUE	FALSE
tamB	FALSE	TRUE	FALSE
ytfP	FALSE	TRUE	FALSE
chpS	FALSE	TRUE	FALSE
chpB	FALSE	TRUE	FALSE
ppa	TRUE	FALSE	FALSE
ytfQ	FALSE	TRUE	FALSE
ytfR	FALSE	TRUE	FALSE
ytfT	FALSE	TRUE	FALSE
yjfF	FALSE	TRUE	FALSE
fbp	FALSE	TRUE	FALSE
mpl	FALSE	TRUE	FALSE
yjgA	FALSE	TRUE	FALSE
pmbA	FALSE	TRUE	FALSE
cybC	FALSE	TRUE	FALSE
nrdG	FALSE	TRUE	FALSE
nrdD	FALSE	TRUE	FALSE
treC	FALSE	TRUE	FALSE
treB	FALSE	TRUE	FALSE
treR	FALSE	TRUE	FALSE
mgtL	FALSE	TRUE	FALSE
mgtA	FALSE	TRUE	FALSE
ridA	FALSE	TRUE	FALSE
pyrI	FALSE	TRUE	FALSE
pyrB	FALSE	TRUE	FALSE
pyrL	FALSE	TRUE	FALSE
yjgH	FALSE	TRUE	FALSE
bdcA	FALSE	TRUE	FALSE
bdcR	FALSE	TRUE	FALSE
tabA	FALSE	TRUE	FALSE
yjgL	FALSE	TRUE	FALSE
argI	FALSE	TRUE	FALSE
rraB	FALSE	TRUE	FALSE
yjgM	FALSE	TRUE	FALSE
yjgN	FALSE	TRUE	FALSE
valS	TRUE	FALSE	FALSE
holC	FALSE	FALSE	TRUE
pepA	FALSE	TRUE	FALSE
lptF	TRUE	FALSE	FALSE
lptG	TRUE	FALSE	FALSE
yjgR	FALSE	TRUE	FALSE
idnR	FALSE	TRUE	FALSE
idnT	FALSE	TRUE	FALSE
idnO	FALSE	TRUE	FALSE
idnD	FALSE	TRUE	FALSE
idnK	FALSE	TRUE	FALSE
ahr	FALSE	TRUE	FALSE
intB	FALSE	TRUE	FALSE
insC1	FALSE	TRUE	FALSE
insD1	FALSE	TRUE	FALSE
yjgX	FALSE	TRUE	FALSE
yjgZ	FALSE	TRUE	FALSE
insG	FALSE	TRUE	FALSE
yjhB	FALSE	TRUE	FALSE
yjhC	FALSE	TRUE	FALSE
ythA	FALSE	TRUE	FALSE
yjhD	FALSE	TRUE	FALSE
yjhE	FALSE	TRUE	FALSE
insO	FALSE	TRUE	FALSE
insI1	FALSE	TRUE	FALSE
insM	FALSE	TRUE	FALSE
yjhV	FALSE	TRUE	FALSE
fecE	FALSE	TRUE	FALSE
fecD	FALSE	TRUE	FALSE
fecC	FALSE	TRUE	FALSE
fecB	FALSE	TRUE	FALSE
fecA	FALSE	TRUE	FALSE
fecR	FALSE	TRUE	FALSE
fecI	FALSE	TRUE	FALSE
insA	FALSE	TRUE	FALSE
insB1	FALSE	TRUE	FALSE
yjhU	FALSE	TRUE	FALSE
yjhF	FALSE	TRUE	FALSE
yjhG	FALSE	TRUE	FALSE
yjhH	FALSE	TRUE	FALSE
yjhI	FALSE	TRUE	FALSE
sgcR	FALSE	TRUE	FALSE
sgcE	FALSE	TRUE	FALSE
sgcA	FALSE	TRUE	FALSE
sgcQ	FALSE	TRUE	FALSE
sgcC	FALSE	TRUE	FALSE
sgcB	FALSE	TRUE	FALSE
sgcX	FALSE	TRUE	FALSE
yjhY	FALSE	TRUE	FALSE
yjhP	FALSE	TRUE	FALSE
yjhQ	FALSE	TRUE	FALSE
yjhX	FALSE	TRUE	FALSE
yjhZ	FALSE	TRUE	FALSE
yjhR	FALSE	TRUE	FALSE
nanS	FALSE	TRUE	FALSE
nanM	FALSE	TRUE	FALSE
nanC	FALSE	TRUE	FALSE
fimB	FALSE	TRUE	FALSE
fimE	FALSE	TRUE	FALSE
fimA	FALSE	TRUE	FALSE
fimI	FALSE	TRUE	FALSE
fimC	FALSE	TRUE	FALSE
fimD	FALSE	TRUE	FALSE
fimF	FALSE	TRUE	FALSE
fimG	FALSE	TRUE	FALSE
fimH	FALSE	TRUE	FALSE
gntP	FALSE	TRUE	FALSE
uxuA	FALSE	TRUE	FALSE
uxuB	FALSE	TRUE	FALSE
uxuR	FALSE	TRUE	FALSE
yjiC	FALSE	TRUE	FALSE
iraD	FALSE	TRUE	FALSE
hypT	FALSE	TRUE	FALSE
iadA	FALSE	TRUE	FALSE
yjiG	FALSE	TRUE	FALSE
yjiH	FALSE	TRUE	FALSE
kptA	FALSE	TRUE	FALSE
yjiJ	FALSE	TRUE	FALSE
yjiK	FALSE	TRUE	FALSE
yjiL	FALSE	TRUE	FALSE
yjiM	FALSE	TRUE	FALSE
yjiN	FALSE	TRUE	FALSE
mdtM	FALSE	TRUE	FALSE
yjiP	FALSE	TRUE	FALSE
yjiR	FALSE	TRUE	FALSE
yjiS	FALSE	TRUE	FALSE
yjiT	FALSE	TRUE	FALSE
yjiV	FALSE	TRUE	FALSE
mcrC	FALSE	TRUE	FALSE
mcrB	FALSE	TRUE	FALSE
symE	FALSE	TRUE	FALSE
hsdS	FALSE	TRUE	FALSE
hsdM	FALSE	TRUE	FALSE
hsdR	FALSE	TRUE	FALSE
mrr	FALSE	TRUE	FALSE
yjiA	FALSE	TRUE	FALSE
yjiX	FALSE	TRUE	FALSE
yjiY	FALSE	TRUE	FALSE
tsr	FALSE	TRUE	FALSE
yjjL	FALSE	TRUE	FALSE
yjjM	FALSE	TRUE	FALSE
yjjN	FALSE	TRUE	FALSE
opgB	FALSE	TRUE	FALSE
yjjA	FALSE	TRUE	FALSE
dnaC	TRUE	FALSE	FALSE
dnaT	TRUE	FALSE	FALSE
yjjB	FALSE	TRUE	FALSE
yjjP	FALSE	TRUE	FALSE
yjjQ	FALSE	TRUE	FALSE
bglJ	FALSE	TRUE	FALSE
fhuF	FALSE	TRUE	FALSE
yjjZ	FALSE	TRUE	FALSE
rsmC	FALSE	TRUE	FALSE
holD	TRUE	FALSE	FALSE
rimI	FALSE	TRUE	FALSE
yjjG	FALSE	TRUE	FALSE
prfC	FALSE	TRUE	FALSE
osmY	FALSE	TRUE	FALSE
ytjA	FALSE	TRUE	FALSE
yjjU	FALSE	TRUE	FALSE
yjjV	FALSE	TRUE	FALSE
yjjW	FALSE	TRUE	FALSE
yjjI	FALSE	TRUE	FALSE
deoC	FALSE	TRUE	FALSE
deoA	FALSE	TRUE	FALSE
deoB	FALSE	TRUE	FALSE
deoD	FALSE	TRUE	FALSE
yjjJ	FALSE	TRUE	FALSE
lplA	FALSE	TRUE	FALSE
ytjB	FALSE	TRUE	FALSE
serB	FALSE	TRUE	FALSE
radA	FALSE	TRUE	FALSE
nadR	FALSE	TRUE	FALSE
yjjK	FALSE	TRUE	FALSE
slt	FALSE	TRUE	FALSE
trpR	FALSE	TRUE	FALSE
yjjX	FALSE	TRUE	FALSE
ytjC	FALSE	TRUE	FALSE
rob	FALSE	TRUE	FALSE
creA	FALSE	TRUE	FALSE
creB	FALSE	TRUE	FALSE
creC	FALSE	TRUE	FALSE
creD	FALSE	TRUE	FALSE
arcA	FALSE	FALSE	TRUE
yjjY	FALSE	TRUE	FALSE
yjtD	FALSE	TRUE	FALSE
